,Unnamed: 0,filename,sentence,up_votes,down_votes,gender,score,duration[ms]
0,48025,common_voice_en_1470.mp3,Everyone seemed very excited.,281,26,male_masculine,255,3624
1,48027,common_voice_en_1472.mp3,The crowd swayed a little as I elbowed my way through.,236,81,male_masculine,155,4704
2,48026,common_voice_en_1471.mp3,He heard a muffled grating sound and saw the black mark jerk forward an inch or so.,214,73,male_masculine,141,6480
3,467230,common_voice_en_10968.mp3,"It was starlight, and I explained the Signs of the Zodiac to her.",90,3,male_masculine,87,6000
4,546618,common_voice_en_37838785.mp3,It was originally chartered as part of Lyman.,84,6,male_masculine,78,4068
5,587014,common_voice_en_3514.mp3,There were lights in the upper windows of the houses when the people went to bed.,80,2,male_masculine,78,6360
6,587011,common_voice_en_3511.mp3,My review of the sun: one star.,77,0,male_masculine,77,3792
7,467232,common_voice_en_10970.mp3,"If you start your emails with ""Greetings"" let me be the first to welcome you to Earth.",80,4,male_masculine,76,7128
8,467238,common_voice_en_10976.mp3,Some of the grey ash was falling off the circular edge.,78,2,male_masculine,76,5808
9,467241,common_voice_en_10980.mp3,"Some went away while I was there, and other people came.",75,3,male_masculine,72,5472
10,467235,common_voice_en_10973.mp3,It had a diameter of about thirty yards.,74,2,male_masculine,72,3216
11,467234,common_voice_en_10972.mp3,But they were not there.,78,6,male_masculine,72,2520
12,587013,common_voice_en_3513.mp3,"If you start your emails with ""Greetings"" let me be the first to welcome you to Earth.",77,5,male_masculine,72,5856
13,467237,common_voice_en_10975.mp3,All that time the Martians must have been getting ready.,76,4,male_masculine,72,4176
14,467243,common_voice_en_10982.mp3,The first rule of don't fight club is let's talk about it.,77,6,male_masculine,71,5760
15,467240,common_voice_en_10978.mp3,"They looked for the fallen mass, but found nothing.",68,3,male_masculine,65,4632
16,467239,common_voice_en_10977.mp3,"Coming home, a party of tourists passed us, singing and playing music.",71,7,male_masculine,64,6912
17,467231,common_voice_en_10969.mp3,I had seen all that it would presently bring me.,69,7,male_masculine,62,5208
18,587022,common_voice_en_3522.mp3,"Coming home, a party of tourists passed us, singing and playing music.",62,0,male_masculine,62,5064
19,467229,common_voice_en_10967.mp3,The top had certainly ceased to rotate.,75,17,male_masculine,58,3000
20,308932,common_voice_en_622.mp3,Every search begins with beginner's luck.,59,2,male_masculine,57,3984
21,587018,common_voice_en_3518.mp3,I have the diet of a kid who found twenty dollars.,56,0,male_masculine,56,3720
22,587019,common_voice_en_3519.mp3,The newspaper articles had prepared everyone for the reception of the idea.,56,1,male_masculine,55,5040
23,587016,common_voice_en_3516.mp3,"Looking through the telescope, I saw a circle of deep blue and the little round planet.",58,3,male_masculine,55,6072
24,587026,common_voice_en_3526.mp3,"Down below in the darkness were hundreds of people, sleeping in peace.",57,2,male_masculine,55,4704
25,587020,common_voice_en_3520.mp3,I found a little crowd of about twenty people surrounding the huge hole.,54,0,male_masculine,54,5088
26,587015,common_voice_en_3515.mp3,This morning I found a calculator taped to my Wii.,54,1,male_masculine,53,5496
27,587023,common_voice_en_3523.mp3,"About eleven, I walked back to my home in Maybury because nothing seemed to be happening.",55,2,male_masculine,53,6912
28,587024,common_voice_en_3524.mp3,"At that time, it was quite clear in my own mind that the thing had come from the planet Mars.",57,4,male_masculine,53,7680
29,308930,common_voice_en_620.mp3,It drew a droplet of blood.,56,4,male_masculine,52,2568
30,467248,common_voice_en_10987.mp3,Most meteorites are more or less rounded.,54,2,male_masculine,52,4248
31,467242,common_voice_en_10981.mp3,No doubt the impact had caused a flash of fire.,60,8,male_masculine,52,3912
32,467256,common_voice_en_10995.mp3,"I need you to be spontaneous. He asked me out to ""din din.""",55,4,male_masculine,51,5832
33,308931,common_voice_en_621.mp3,"The horse reared again, raising a cloud of dust.",55,4,male_masculine,51,3504
34,587017,common_voice_en_3517.mp3,The end of the cylinder was still as Ogilvy and Henderson had left it.,56,6,male_masculine,50,6264
35,308938,common_voice_en_630.mp3,And the names of the people involved were very difficult to pronounce.,49,0,male_masculine,49,4344
36,308935,common_voice_en_626.mp3,"To do that successfully, I must have no fear of failure.",51,2,male_masculine,49,3912
37,587029,common_voice_en_3529.mp3,"There were really, I think, two or three hundred people elbowing one another.",51,2,male_masculine,49,5952
38,308928,common_voice_en_617.mp3,"Because my eyes are not yet accustomed to the desert, the boy said.",52,3,male_masculine,49,4488
39,308937,common_voice_en_629.mp3,He got up early with the idea of finding it.,50,2,male_masculine,48,3456
40,467249,common_voice_en_10988.mp3,"You should see the other guy, specifically, how good at fighting he is.",51,3,male_masculine,48,5208
41,454573,common_voice_en_38318419.mp3,They regulated their calendar primarily by observation of the moon.,48,0,male_masculine,48,6408
42,378297,common_voice_en_1131.mp3,He got up early with the idea of finding it.,48,1,male_masculine,47,3024
43,332634,common_voice_en_43183.mp3,He got up early with the idea of finding it.,48,1,male_masculine,47,2544
44,378287,common_voice_en_1121.mp3,"You must always know what it is that you want, the old king had said.",47,1,male_masculine,46,6024
45,308926,common_voice_en_615.mp3,I sold crystal and crossed the desert.,48,2,male_masculine,46,2472
46,308925,common_voice_en_614.mp3,He remembered something his grandfather had once told him: that butterflies were a good omen.,47,1,male_masculine,46,6144
47,378294,common_voice_en_1128.mp3,He was shaken into wakefulness by someone.,46,1,male_masculine,45,3768
48,587027,common_voice_en_3527.mp3,"As soon as he saw me among the crowd, he called to me to come down.",47,2,male_masculine,45,5376
49,332632,common_voice_en_43181.mp3,Everyone seemed very excited.,46,1,male_masculine,45,2856
50,1093912,common_voice_en_38743229.mp3,"Almalki's case was taken up by many organizations in Canada, including Amnesty International.",45,0,male_masculine,45,7524
51,1093745,common_voice_en_38739453.mp3,There have also been numerous unlicensed copies.,50,5,male_masculine,45,5004
52,467253,common_voice_en_10992.mp3,The only shadow was that of the few scattered pine trees.,49,4,male_masculine,45,4824
53,467246,common_voice_en_10985.mp3,They set off running wildly into the trees.,47,3,male_masculine,44,4032
54,587025,common_voice_en_3525.mp3,But I found it difficult to get to work because of the investigations.,47,3,male_masculine,44,4512
55,467254,common_voice_en_10993.mp3,He just got a new kite for his birthday.,50,6,male_masculine,44,3576
56,467245,common_voice_en_10984.mp3,It left a greenish streak that glowed for some seconds.,46,3,male_masculine,43,5040
57,587028,common_voice_en_3528.mp3,Ogilvy told him everything that he had seen.,46,3,male_masculine,43,3816
58,378289,common_voice_en_1123.mp3,He was more certain of it than of anything in the world.,43,0,male_masculine,43,4488
59,263376,common_voice_en_811.mp3,He has other things to do first.,45,2,male_masculine,43,3048
60,279693,common_voice_en_1507.mp3,I SHALL MAKE US SOME ICE CUBES.,42,0,male_masculine,42,2640
61,378290,common_voice_en_1124.mp3,He was alarmed by what had happened.,43,1,male_masculine,42,3144
62,412801,common_voice_en_174.mp3,"If he makes a buying mistake, it doesn't affect him much.",42,0,male_masculine,42,4320
63,412800,common_voice_en_173.mp3,"The boy offered his bottle, hoping that the old man would leave him alone.",43,1,male_masculine,42,5352
64,467247,common_voice_en_10986.mp3,I wished I had a light to smoke by.,46,4,male_masculine,42,4056
65,263374,common_voice_en_809.mp3,"I'll just watch him, he said to himself.",43,2,male_masculine,41,4776
66,587039,common_voice_en_3539.mp3,I myself heard nothing of that.,43,2,male_masculine,41,2736
67,412796,common_voice_en_169.mp3,It was such a gradual movement that he found it only by noticing the dots.,42,1,male_masculine,41,5784
68,587036,common_voice_en_3536.mp3,I locked eyes with a fish in the tank.,41,0,male_masculine,41,2928
69,412789,common_voice_en_161.mp3,Don't ask me why; I don't know why.,43,2,male_masculine,41,3600
70,412799,common_voice_en_172.mp3,He wasn't an alchemist!,44,3,male_masculine,41,2568
71,332635,common_voice_en_43184.mp3,"In spite of this, I still believed that there were men in Mars.",41,1,male_masculine,40,3936
72,412787,common_voice_en_159.mp3,"And, if you improve on the present, what comes later will also be better.",40,0,male_masculine,40,4704
73,308936,common_voice_en_627.mp3,"But, just before lunchtime, a boy stopped in front of the shop.",46,6,male_masculine,40,4584
74,587021,common_voice_en_3521.mp3,I have already described the appearance of that colossal bulk which was embedded in the ground.,42,2,male_masculine,40,7224
75,332629,common_voice_en_43178.mp3,You can't believe it's not butter?,42,2,male_masculine,40,2544
76,1093877,common_voice_en_38741484.mp3,It is part of the Marine Corps Base Camp Smedley D. Butler complex.,40,0,male_masculine,40,5472
77,467252,common_voice_en_10991.mp3,"The level ground was blackened as far as one could see, and it was still giving off smoke.",42,2,male_masculine,40,6624
78,587034,common_voice_en_3534.mp3,"I remember how I sat on the table there in the blackness, with patches of green and crimson swimming before my eyes.",40,0,male_masculine,40,7128
79,332624,common_voice_en_43173.mp3,I would have won the Junior Olympics if not for those medaling kids.,41,1,male_masculine,40,4824
80,308927,common_voice_en_616.mp3,I don't know the desert that well yet.,46,7,male_masculine,39,2256
81,378281,common_voice_en_1115.mp3,Then a man approached.,40,1,male_masculine,39,3768
82,587033,common_voice_en_3533.mp3,I went stretching my legs clumsily and feeling my way in the dark.,40,1,male_masculine,39,6168
83,587032,common_voice_en_3532.mp3,The thing itself was almost entirely buried in sand.,41,2,male_masculine,39,4440
84,412788,common_voice_en_160.mp3,"And it's not love to see everything from a distance, like you do.",39,0,male_masculine,39,4344
85,378284,common_voice_en_1118.mp3,Because you will never again be able to keep it quiet.,40,1,male_masculine,39,4416
86,308933,common_voice_en_623.mp3,"It's not what enters men's mouths that's evil, said the alchemist.",44,5,male_masculine,39,5304
87,587052,common_voice_en_3552.mp3,No one seemed to have thought about it that night.,41,2,male_masculine,39,3624
88,587041,common_voice_en_3541.mp3,The turf and gravel around it seemed charred as if by a sudden explosion.,39,0,male_masculine,39,5400
89,467250,common_voice_en_10989.mp3,"Air was either entering or escaping at the rim with a thin, sizzling sound.",41,3,male_masculine,38,7800
90,308929,common_voice_en_618.mp3,He needed someone to talk to so as to avoid thinking about the possibility of war.,41,3,male_masculine,38,5304
91,587043,common_voice_en_3543.mp3,It was faintly marked with transverse stripes and slightly flattened from the perfect round.,38,0,male_masculine,38,6864
92,587040,common_voice_en_3540.mp3,You point to a trail of ants leading into the house.,38,0,male_masculine,38,4248
93,263377,common_voice_en_812.mp3,He picked up the two stones and put them back in his pouch.,40,3,male_masculine,37,5304
94,332626,common_voice_en_43175.mp3,I found a little crowd of about twenty people surrounding the huge hole.,38,1,male_masculine,37,3864
95,378292,common_voice_en_1126.mp3,"And this is for me, said the alchemist, keeping one of the parts.",39,2,male_masculine,37,5664
96,412804,common_voice_en_178.mp3,Don't forget that everything you deal with is only one thing and nothing else.,40,3,male_masculine,37,5544
97,467233,common_voice_en_10971.mp3,The end of the cylinder was still as Ogilvy and Henderson had left it.,59,23,male_masculine,36,9288
98,279698,common_voice_en_1512.mp3,They set off running wildly into the trees.,37,1,male_masculine,36,3360
99,263371,common_voice_en_806.mp3,You could have died after peace had been declared.,40,4,male_masculine,36,5688
100,587047,common_voice_en_3547.mp3,The burning fire had been extinguished.,36,0,male_masculine,36,3480
101,587037,common_voice_en_3537.mp3,"I had the ""everyone has Gary Busey's teeth"" dream again.",37,1,male_masculine,36,5208
102,378286,common_voice_en_1120.mp3,"But, if you can, try to make your own decisions.",37,1,male_masculine,36,4680
103,378285,common_voice_en_1119.mp3,I found a little crowd of about twenty people surrounding the huge hole.,36,0,male_masculine,36,6144
104,332622,common_voice_en_43171.mp3,The top had certainly ceased to rotate.,37,1,male_masculine,36,2544
105,332631,common_voice_en_43180.mp3,I'm going to them.,36,0,male_masculine,36,2256
106,378291,common_voice_en_1125.mp3,"He didn't want his hand to begin trembling, showing the old woman that he was fearful.",38,2,male_masculine,36,8496
107,378280,common_voice_en_1114.mp3,"And he asked the boy if he, too, were in search of the alchemist.",36,1,male_masculine,35,6792
108,587042,common_voice_en_3542.mp3,"We don't know what's in the confounded thing, do you?",35,0,male_masculine,35,3888
109,308934,common_voice_en_625.mp3,"He came to understand its dodges and tricks, and to accept it as it was.",38,3,male_masculine,35,4536
110,587038,common_voice_en_3538.mp3,I heard a peculiar humming sound from the pit.,37,2,male_masculine,35,3720
111,587031,common_voice_en_3531.mp3,Some storms are worth the wreckage.,35,0,male_masculine,35,3192
112,378288,common_voice_en_1122.mp3,"I'll work all night, until dawn, and I'll clean every piece of crystal in your shop.",36,1,male_masculine,35,7800
113,467255,common_voice_en_10994.mp3,I was impatient to see it opened.,38,3,male_masculine,35,3288
114,332625,common_voice_en_43174.mp3,A large piece suddenly came off and fell with a loud and sharp noise.,35,0,male_masculine,35,4416
115,279694,common_voice_en_1508.mp3,Many telescopes were pointed at it.,38,3,male_masculine,35,2664
116,587054,common_voice_en_3554.mp3,The streamer of gas came out towards us.,36,1,male_masculine,35,3912
117,467251,common_voice_en_10990.mp3,The guy thought he was a lunatic at large and made an unsuccessful attempt to stop him.,42,7,male_masculine,35,8160
118,332636,common_voice_en_43185.mp3,The streamer of gas came out towards us.,35,1,male_masculine,34,2976
119,587048,common_voice_en_3548.mp3,"My wife pointed out to me the brightness of the red, green, and yellow signal lights.",36,2,male_masculine,34,5712
120,412798,common_voice_en_171.mp3,They stood there looking at the moon.,36,2,male_masculine,34,2664
121,467244,common_voice_en_10983.mp3,"There were raised voices,and some sort of struggle appeared to be going on. .",47,14,male_masculine,33,5664
122,412795,common_voice_en_168.mp3,Don't try to enter into the life of the oasis.,36,3,male_masculine,33,4128
123,263378,common_voice_en_813.mp3,"The strange horseman drew an enormous, curved sword from a scabbard mounted on his saddle.",33,1,male_masculine,32,9240
124,587053,common_voice_en_3553.mp3,"In spite of this, I still believed that there were men in Mars.",32,0,male_masculine,32,4248
125,587049,common_voice_en_3549.mp3,There was very little talking.,34,2,male_masculine,32,2616
126,378283,common_voice_en_1117.mp3,"He wandered for a while, keeping the date palms of the oasis within sight.",32,1,male_masculine,31,5544
127,378279,common_voice_en_1113.mp3,I think they perceived that nothing was to be done at the moment.,32,1,male_masculine,31,4584
128,352697,common_voice_en_1341.mp3,The wind began to blow again.,32,1,male_masculine,31,3456
129,263370,common_voice_en_805.mp3,Why a revolver? he asked.,36,5,male_masculine,31,3864
130,587044,common_voice_en_3544.mp3,He approached the mass and was surprised at the size and the shape.,31,0,male_masculine,31,4584
131,587050,common_voice_en_3550.mp3,Can I get a woot woot!?,36,5,male_masculine,31,3168
132,587046,common_voice_en_3546.mp3,Even then he hardly understood what this meant.,31,0,male_masculine,31,3792
133,412805,common_voice_en_179.mp3,"We were all made by the same hand, and we have the same soul.",37,6,male_masculine,31,4752
134,412786,common_voice_en_158.mp3,"Where do you live? shouted the boy, as the horseman rode away.",35,4,male_masculine,31,4056
135,412790,common_voice_en_162.mp3,"But instead of being saddened, he was happy.",34,3,male_masculine,31,4320
136,263372,common_voice_en_807.mp3,He brought six sheep with him.,31,1,male_masculine,30,2832
137,587051,common_voice_en_3551.mp3,He had seen the shooting star and was persuaded that a meteorite lay somewhere nearby.,32,2,male_masculine,30,6864
138,332633,common_voice_en_43182.mp3,It seemed to him that it fell to earth about one hundred miles east of here.,30,0,male_masculine,30,3984
139,279701,common_voice_en_1515.mp3,A line of flame high can be seen in the atmosphere.,31,1,male_masculine,30,3984
140,279696,common_voice_en_1510.mp3,Scattered groups of people were hurrying from the direction of Woking.,31,2,male_masculine,29,4536
141,263373,common_voice_en_808.mp3,"He knew what I was thinking, the boy said to himself.",36,7,male_masculine,29,5208
142,587045,common_voice_en_3545.mp3,I got drunk yesterday and thought I built a super computer.,30,1,male_masculine,29,4008
143,279692,common_voice_en_1506.mp3,My review of the sun: one star.,31,2,male_masculine,29,3840
144,378282,common_voice_en_1116.mp3,"The sea has lived on in this shell, because that's its destiny.",30,2,male_masculine,28,5424
145,279699,common_voice_en_1513.mp3,"At the first glance, it was really not very exciting.",29,1,male_masculine,28,3768
146,274544,common_voice_en_2132.mp3,Some do come back.,27,0,male_masculine,27,3504
147,301226,common_voice_en_1209.mp3,"I don't know how to find life in the desert, the boy said.",28,1,male_masculine,27,4848
148,279703,common_voice_en_1517.mp3,He had seen the shooting star and was persuaded that a meteorite lay somewhere nearby.,30,3,male_masculine,27,4704
149,412794,common_voice_en_167.mp3,Every search begins with beginner's luck.,28,1,male_masculine,27,3672
150,301234,common_voice_en_1217.mp3,He told her about the morning's meeting.,27,0,male_masculine,27,3888
151,412803,common_voice_en_177.mp3,"What's the world's greatest lie? the boy asked, completely surprised.",36,9,male_masculine,27,6384
152,1416307,common_voice_en_37306512.mp3,The Western Isles is a member of the International Island Games Association.,30,3,male_masculine,27,7200
153,378293,common_voice_en_1127.mp3,"Since the miner had sacrificed everything to his destiny, the old man decided to become involved.",30,3,male_masculine,27,8832
154,332623,common_voice_en_43172.mp3,What had been next to him five minutes ago was now at the other side.,26,0,male_masculine,26,3936
155,1705707,common_voice_en_38233263.mp3,She was involved in cases involving health and safety law and money laundering.,28,2,male_masculine,26,8460
156,332630,common_voice_en_43179.mp3,The thought was so dreadful to him that he forgot about the heat and went forward.,31,5,male_masculine,26,4416
157,378296,common_voice_en_1130.mp3,"The boy noticed that the owner of the bar stood nearby, listening attentively to their conversation.",29,3,male_masculine,26,7104
158,352693,common_voice_en_1337.mp3,I locked eyes with a fish in the tank.,26,0,male_masculine,26,3336
159,274553,common_voice_en_2141.mp3,I found these one day in the fields.,27,1,male_masculine,26,3816
160,279700,common_voice_en_1514.mp3,That sobered him a little.,30,5,male_masculine,25,1824
161,352699,common_voice_en_1343.mp3,"They spoke about mercury, salt, dragons, and kings, and he didn't understand any of it.",25,0,male_masculine,25,7704
162,352690,common_voice_en_1334.mp3,The idea frightened him.,25,0,male_masculine,25,2016
163,332628,common_voice_en_43177.mp3,"At that time, it was quite clear in my own mind that the thing had come from the planet Mars.",27,2,male_masculine,25,5736
164,274555,common_voice_en_2143.mp3,Based on the omens of the present.,27,2,male_masculine,25,2832
165,1139414,common_voice_en_33151102.mp3,Price was thirteen when she landed in Tennessee.,24,0,male_masculine,24,3492
166,780587,common_voice_en_9157.mp3,The boy's name was Santiago.,24,0,male_masculine,24,3024
167,412785,common_voice_en_157.mp3,The top had certainly ceased to rotate.,27,3,male_masculine,24,4224
168,780545,common_voice_en_9114.mp3,Because you have already lost your savings twice.,25,1,male_masculine,24,3696
169,760001,common_voice_en_16635.mp3,"Had our instruments permitted it, we might have been able to see the trouble way back when.",24,0,male_masculine,24,5520
170,1804754,common_voice_en_23355029.mp3,"Together with Helen Marden, they have two daughters, Mirabelle and Melia.",26,2,male_masculine,24,7224
171,301225,common_voice_en_1208.mp3,He remembered the sword.,24,0,male_masculine,24,2688
172,1310223,common_voice_en_36878121.mp3,The finds are mainly obsidian products.,24,0,male_masculine,24,2808
173,352684,common_voice_en_1327.mp3,"The world speaks many languages, the boy thought.",24,0,male_masculine,24,4056
174,412793,common_voice_en_166.mp3,"I think it's about bird hunting, but now I can see how that might be misinterpreted.",30,7,male_masculine,23,6912
175,1319462,common_voice_en_513961.mp3,"If you start your emails with ""Greetings"" let me be the first to welcome you to Earth.",23,0,male_masculine,23,7776
176,412797,common_voice_en_170.mp3,"And there were dunes, rocks, and plants that insisted on living where survival seemed impossible.",26,3,male_masculine,23,6048
177,332627,common_voice_en_43176.mp3,Henderson stood up with a spade in his hand.,23,0,male_masculine,23,3024
178,352688,common_voice_en_1332.mp3,"When you play cards the first time, you are almost sure to win.",23,1,male_masculine,22,5184
179,352692,common_voice_en_1336.mp3,"Well, usually I learn more from my sheep than from books, he answered.",22,0,male_masculine,22,5016
180,780579,common_voice_en_9149.mp3,"He listened to the wind, and felt the stones beneath his feet.",23,1,male_masculine,22,4104
181,780598,common_voice_en_9168.mp3,"I can clean up those glasses in the window, if you want, said the boy.",22,0,male_masculine,22,4344
182,1058148,common_voice_en_121087.mp3,"From the railway station in the distance came the sound of trains, ringing and rumbling.",24,2,male_masculine,22,5784
183,274549,common_voice_en_2137.mp3,He saw that Fatima's eyes were filled with tears.,24,2,male_masculine,22,4320
184,269903,common_voice_en_38582448.mp3,This look is almost universally used with one fullback one halfback.,22,0,male_masculine,22,5796
185,530498,common_voice_en_7877.mp3,Absolutely despicable that gingerbread men are forced to live in houses made of their own flesh.,24,2,male_masculine,22,5880
186,450859,common_voice_en_3422.mp3,"The old man was probably a Gypsy, too.",23,1,male_masculine,22,4992
187,956968,common_voice_en_37531352.mp3,During floods the creek becomes a braided channel.,22,0,male_masculine,22,4284
188,274552,common_voice_en_2140.mp3,He decided to stay right there and await his return.,24,3,male_masculine,21,4824
189,274546,common_voice_en_2134.mp3,"His new friend pushed the owner aside, and pulled the boy outside with him.",24,3,male_masculine,21,6624
190,412806,common_voice_en_180.mp3,He could always go back to being a shepherd.,24,3,male_masculine,21,3240
191,301107,common_voice_en_9800.mp3,Even then he hardly understood what this meant.,21,0,male_masculine,21,3552
192,279695,common_voice_en_1509.mp3,I found a little crowd of about twenty people surrounding the huge hole.,22,1,male_masculine,21,4728
193,279702,common_voice_en_1516.mp3,"You don't have to be rich, skinny, popular, or even own a cape to perform a random act of kindness.",24,3,male_masculine,21,5904
194,530479,common_voice_en_7857.mp3,All that time the Martians must have been getting ready.,21,0,male_masculine,21,5664
195,352689,common_voice_en_1333.mp3,He brought six sheep with him.,22,1,male_masculine,21,2664
196,352698,common_voice_en_1342.mp3,"Don't be impatient, he repeated to himself.",21,0,male_masculine,21,3624
197,1285778,common_voice_en_31502165.mp3,Mathematician Paul Althaus Smith was consulted to help with formatting the unique game.,21,0,male_masculine,21,7920
198,780535,common_voice_en_9104.mp3,"They're not worth much, the Englishman answered.",20,0,male_masculine,20,3144
199,530475,common_voice_en_7853.mp3,He stood irresolute for a moment and then scrambled out of the pit.,23,3,male_masculine,20,10896
200,263369,common_voice_en_804.mp3,The woman was silent for some time.,20,0,male_masculine,20,3192
201,503400,common_voice_en_12991.mp3,The boy didn't want to talk about the Pyramids.,20,0,male_masculine,20,3600
202,1825695,common_voice_en_32357777.mp3,Its native range is Peninsula Malaysia.,22,2,male_masculine,20,4140
203,450858,common_voice_en_3421.mp3,"Well, I'd like to see their land, and see how they live, said his son.",20,0,male_masculine,20,7008
204,453439,common_voice_en_10644.mp3,Many telescopes were pointed at it.,20,0,male_masculine,20,2904
205,772370,common_voice_en_13343.mp3,Ogilvy told him everything that he had seen.,20,0,male_masculine,20,3624
206,780577,common_voice_en_9147.mp3,So now I'm a camel driver.,21,1,male_masculine,20,3096
207,610485,common_voice_en_35337682.mp3,At least two genera are known from Antarctica.,20,0,male_masculine,20,4716
208,450835,common_voice_en_3398.mp3,It turned out to be a bitter tea.,21,1,male_masculine,20,4992
209,1455712,common_voice_en_35193836.mp3,The album was played in full.,20,0,male_masculine,20,3276
210,1319479,common_voice_en_513980.mp3,"There was a lot of shouting, and one man was even jesting.",20,0,male_masculine,20,4296
211,780561,common_voice_en_9130.mp3,"All I saw was an army, said the boy.",20,0,male_masculine,20,2976
212,352691,common_voice_en_1335.mp3,"When he had completed the cleaning, he asked the man for something to eat.",21,1,male_masculine,20,5016
213,301233,common_voice_en_1216.mp3,"They forgot that lead, copper, and iron have their own destinies to fulfill.",20,0,male_masculine,20,5520
214,301227,common_voice_en_1210.mp3,Now his intuition was that he had been right in coming.,22,3,male_masculine,19,5160
215,587035,common_voice_en_3535.mp3,Hires two personal trainers and make one of them train the other one.,28,9,male_masculine,19,4800
216,272874,common_voice_en_15946.mp3,"In spite of this, I still believed that there were men in Mars.",19,0,male_masculine,19,6480
217,772368,common_voice_en_13341.mp3,"It seemed such a little thing, so bright and small and still.",20,1,male_masculine,19,6024
218,263368,common_voice_en_803.mp3,"You and I aren't like Hassan, that rich merchant.",20,1,male_masculine,19,4704
219,503395,common_voice_en_12986.mp3,The boy knew the desert sensed his fear.,19,0,male_masculine,19,3864
220,780570,common_voice_en_9139.mp3,"I'm not going to charge you anything now, she said.",19,0,male_masculine,19,3456
221,772390,common_voice_en_13363.mp3,That sobered him a little.,19,0,male_masculine,19,2688
222,776437,common_voice_en_13620.mp3,He was alarmed by what had happened.,19,0,male_masculine,19,3864
223,780602,common_voice_en_9172.mp3,They could barely see the boy.,19,0,male_masculine,19,1944
224,352694,common_voice_en_1338.mp3,The boy was also saddened; his friend was in pursuit of his destiny.,19,0,male_masculine,19,5784
225,772399,common_voice_en_13372.mp3,The burning fire had been extinguished.,19,0,male_masculine,19,3792
226,508900,common_voice_en_9545.mp3,"I've already had that experience with my sheep, and now it's happening with people.",19,0,male_masculine,19,5664
227,780584,common_voice_en_9154.mp3,"If he makes a buying mistake, it doesn't affect him much.",19,0,male_masculine,19,3864
228,279697,common_voice_en_1511.mp3,YOU WANNA TAKE THIS OUTSIDE?,22,4,male_masculine,18,1992
229,780542,common_voice_en_9111.mp3,Some of the grey ash was falling off the circular edge.,18,0,male_masculine,18,3456
230,338474,common_voice_en_41178.mp3,"Then he dropped his spade, picked up his jacket, and came out into the road.",18,0,male_masculine,18,5592
231,1415955,common_voice_en_37289915.mp3,"A lifelong bachelor, he was survived by his sisters, nieces and nephews.",18,0,male_masculine,18,7668
232,587012,common_voice_en_3512.mp3,But I didn’t think that it contained any living creature.,22,4,male_masculine,18,3864
233,503407,common_voice_en_12998.mp3,"But the marketplace was empty, and he was far from home, so he wept.",18,0,male_masculine,18,6168
234,274551,common_voice_en_2139.mp3,"He knew what I was thinking, the boy said to himself.",22,4,male_masculine,18,5472
235,530483,common_voice_en_7861.mp3,Will you give me your blessing? asked the boy.,18,0,male_masculine,18,5184
236,274550,common_voice_en_2138.mp3,have trusted more in your love for Fatima.,24,6,male_masculine,18,3792
237,508873,common_voice_en_9518.mp3,I SHALL MAKE US SOME ICE CUBES.,18,0,male_masculine,18,2880
238,772373,common_voice_en_13346.mp3,It must have fallen while I was sitting over there.,18,0,male_masculine,18,3384
239,859070,common_voice_en_16231.mp3,"Looking through the telescope, I saw a circle of deep blue and the little round planet.",19,1,male_masculine,18,6984
240,454441,common_voice_en_39582470.mp3,But that’s because I’m used to Edgar and Isabella Linton.,18,0,male_masculine,18,3996
241,761431,common_voice_en_37269918.mp3,In this town actress Ofelia Cano was born.,18,0,male_masculine,18,4320
242,172857,common_voice_en_7989.mp3,"He did find it, soon after dawn, and not far from the sand pits.",18,0,male_masculine,18,5544
243,780551,common_voice_en_9120.mp3,"You can't offer me something that is already mine, the chief said, arrogantly.",18,0,male_masculine,18,5136
244,1829698,common_voice_en_36636888.mp3,They were ordered to fast for ten days in the usual manner.,20,2,male_masculine,18,7092
245,453438,common_voice_en_10643.mp3,"And at that I told him, and he took my place.",18,0,male_masculine,18,3384
246,546608,common_voice_en_37838732.mp3,Today the event attracts over a million visitors to Nice every year.,18,0,male_masculine,18,8028
247,741185,common_voice_en_38502789.mp3,Macindoe played for Glasgow Academicals.,20,2,male_masculine,18,4896
248,546592,common_voice_en_37838681.mp3,The College also features its own deli: Ctrl-Alt-Deli.,18,0,male_masculine,18,6120
249,378295,common_voice_en_1129.mp3,The boy's name was Santiago.,18,0,male_masculine,18,2184
250,352695,common_voice_en_1339.mp3,Absolutely despicable that gingerbread men are forced to live in houses made of their own flesh.,18,0,male_masculine,18,7824
251,1415808,common_voice_en_37289521.mp3,Located north of the Golden Ring of Russia.,18,0,male_masculine,18,3888
252,1368347,common_voice_en_36382677.mp3,Somebody must take care of the Etruscans and prepare vessels of honor at home.,21,3,male_masculine,18,9036
253,772335,common_voice_en_13307.mp3,I would have won the Junior Olympics if not for those medaling kids.,18,0,male_masculine,18,5424
254,301228,common_voice_en_1211.mp3,No one paid any attention to the two travelers.,18,0,male_masculine,18,4344
255,628185,common_voice_en_11836.mp3,"They were people of the desert, and clamored to hear his stories about the great cities.",18,0,male_masculine,18,6192
256,1044669,common_voice_en_18916.mp3,They tell their incredible stories at the time when you want to hear them.,18,0,male_masculine,18,4656
257,329753,common_voice_en_3507.mp3,"From then on, he would make his own decisions.",18,0,male_masculine,18,4440
258,780534,common_voice_en_9103.mp3,The Soul of the World is nourished by people's happiness.,20,2,male_masculine,18,4464
259,1831644,common_voice_en_37387464.mp3,"That year, she made her fourth chart entry with the song Corn Fed.",18,0,male_masculine,18,5580
260,1833589,common_voice_en_38667442.mp3,Holly's system of pumping water into Lockport's city mains was unique.,18,0,male_masculine,18,8028
261,772377,common_voice_en_13350.mp3,"You should see the other guy, specifically, how good at fighting he is.",17,0,male_masculine,17,5424
262,859090,common_voice_en_16251.mp3,Henderson stood up with a spade in his hand.,17,0,male_masculine,17,3264
263,772369,common_voice_en_13342.mp3,It was such a gradual movement that he found it only by noticing the dots.,17,0,male_masculine,17,6072
264,508875,common_voice_en_9520.mp3,Then suddenly he noticed it with a start.,17,0,male_masculine,17,4488
265,508874,common_voice_en_9519.mp3,"I'm an adventurer, looking for treasure, he said to himself.",17,0,male_masculine,17,4176
266,301104,common_voice_en_9797.mp3,I myself heard nothing of that.,17,0,male_masculine,17,3288
267,1319649,common_voice_en_514164.mp3,"He stood silent and motionless, regarding me.",17,0,male_masculine,17,4248
268,780576,common_voice_en_9146.mp3,They rode for the entire day.,19,2,male_masculine,17,2184
269,776406,common_voice_en_13589.mp3,He had never imagined that questions about life would be of such importance to a shepherd.,17,0,male_masculine,17,7056
270,352686,common_voice_en_1330.mp3,"One afternoon, one of his servants fell ill, and it appeared that he would die.",17,0,male_masculine,17,6744
271,780574,common_voice_en_9144.mp3,He spent the entire morning observing the infrequent comings and goings in the street.,17,0,male_masculine,17,4344
272,628153,common_voice_en_11804.mp3,The woman was silent for some time.,19,2,male_masculine,17,2688
273,859078,common_voice_en_16239.mp3,We lit the lantern and walked over to his house.,17,0,male_masculine,17,3480
274,508887,common_voice_en_9532.mp3,Butmaybe I'll never have another chance to get to the Pyramids in Egypt.,17,0,male_masculine,17,4680
275,167805,common_voice_en_10056.mp3,It was the pure Language of the World.,17,0,male_masculine,17,3648
276,780522,common_voice_en_9090.mp3,"But, as time passed, Tangier had changed.",20,3,male_masculine,17,4056
277,776465,common_voice_en_13649.mp3,The boy trusted his new friend.,17,0,male_masculine,17,3264
278,772349,common_voice_en_13321.mp3,I have already described the appearance of that colossal bulk which was embedded in the ground.,17,0,male_masculine,17,6384
279,563654,common_voice_en_18007.mp3,Strange images passed through my mind.,17,0,male_masculine,17,3576
280,453443,common_voice_en_10652.mp3,The first rule of don't fight club is let's talk about it.,19,2,male_masculine,17,4032
281,274554,common_voice_en_2142.mp3,"He told Fatima that, at their next meeting.",25,8,male_masculine,17,4152
282,301232,common_voice_en_1215.mp3,He had been so far away that his face wasn't even visible.,17,0,male_masculine,17,5712
283,28237,common_voice_en_9445.mp3,"We don't know when the war will end, so we can't continue our journey, he said.",17,0,male_masculine,17,5808
284,772329,common_voice_en_13301.mp3,My review of the sun: one star.,18,1,male_masculine,17,3504
285,301109,common_voice_en_9802.mp3,Strange images passed through my mind.,17,0,male_masculine,17,3336
286,530494,common_voice_en_7873.mp3,He spent the entire morning observing the infrequent comings and goings in the street.,17,0,male_masculine,17,8424
287,1319555,common_voice_en_514063.mp3,Some storms are worth the wreckage.,17,0,male_masculine,17,4392
288,859144,common_voice_en_16305.mp3,The only shadow was that of the few scattered pine trees.,17,0,male_masculine,17,3696
289,780516,common_voice_en_9084.mp3,"I can learn something from the desert, too.",18,1,male_masculine,17,2304
290,859101,common_voice_en_16262.mp3,You can't believe it's not butter?,17,0,male_masculine,17,2784
291,301105,common_voice_en_9798.mp3,You point to a trail of ants leading into the house.,18,1,male_masculine,17,3576
292,628183,common_voice_en_11834.mp3,It was the time of day when all of Spain slept during the summer.,17,0,male_masculine,17,4344
293,352696,common_voice_en_1340.mp3,There was enough there to buy a lot of weapons.,16,0,male_masculine,16,3264
294,772396,common_voice_en_13369.mp3,Even then he hardly understood what this meant.,17,1,male_masculine,16,3672
295,760004,common_voice_en_16638.mp3,"He moved about, invisible but everyone could hear him.",16,0,male_masculine,16,4968
296,772397,common_voice_en_13370.mp3,And then he perceived it very slowly.,16,0,male_masculine,16,3792
297,780583,common_voice_en_9153.mp3,My friend bought all the other sheep immediately.,17,1,male_masculine,16,3984
298,776422,common_voice_en_13605.mp3,"The desert was all sand in some stretches, and rocky in others.",16,0,male_masculine,16,5616
299,776435,common_voice_en_13618.mp3,"An old man, with a breastplate of gold, wouldn't have lied just to acquire six sheep.",16,0,male_masculine,16,7224
300,381754,common_voice_en_12254.mp3,Something inside the cylinder was unscrewing the top.,17,1,male_masculine,16,3456
301,760024,common_voice_en_16658.mp3,"You don't have to be rich, skinny, popular, or even own a cape to perform a random act of kindness.",16,0,male_masculine,16,6456
302,1368909,common_voice_en_36402909.mp3,"She has a house in Truro, Massachusetts on Cape Cod.",16,0,male_masculine,16,4932
303,772394,common_voice_en_13367.mp3,It may be the gases of the firing that caused the Martians inconvenience.,16,0,male_masculine,16,5664
304,1413531,common_voice_en_30150931.mp3,He is also good at painting.,16,0,male_masculine,16,2808
305,1059442,common_voice_en_36814150.mp3,"Fruit salad is another simple, yet traditional, dessert eaten in Costa Rica.",16,0,male_masculine,16,5292
306,772388,common_voice_en_13361.mp3,He heard a muffled grating sound and saw the black mark jerk forward an inch or so.,16,0,male_masculine,16,5808
307,1368792,common_voice_en_36181642.mp3,These thermal waters are absolutely colorless.,16,0,male_masculine,16,4392
308,772413,common_voice_en_13386.mp3,It was no more exciting than an overturned carriage or a tree blown across the road.,16,0,male_masculine,16,6336
309,1703979,common_voice_en_35213904.mp3,The earliest marine reptiles arose in the Permian period during the Paleozoic era.,16,0,male_masculine,16,8316
310,172901,common_voice_en_11186.mp3,"The dead soldiers were replaced by others, and life went on.",16,0,male_masculine,16,7296
311,1702179,common_voice_en_30409290.mp3,Dorothy Wall,16,0,male_masculine,16,2196
312,780581,common_voice_en_9151.mp3,"The shop folks were taking down their shutters, and people were opening their bedroom windows.",17,1,male_masculine,16,6336
313,780580,common_voice_en_9150.mp3,"This is why alchemy exists, the boy said.",16,0,male_masculine,16,4056
314,1068113,common_voice_en_32299881.mp3,Reception to the third season has been positive.,16,0,male_masculine,16,3528
315,772405,common_voice_en_13378.mp3,"At once, he connected the two incidents.",16,0,male_masculine,16,3720
316,352700,common_voice_en_1344.mp3,"Let's, the alchemist answered.",17,1,male_masculine,16,3024
317,274545,common_voice_en_2133.mp3,"I am in search of that universal language, among other things.",18,2,male_masculine,16,5592
318,898255,common_voice_en_37811184.mp3,It seemed to me that it would be quite a natural conclusion.,16,0,male_masculine,16,5220
319,772402,common_voice_en_13375.mp3,"You don't have to be rich, skinny, popular, or even own a cape to perform a random act of kindness.",16,0,male_masculine,16,7200
320,922439,common_voice_en_38359605.mp3,About half of those were posted in the interior and along the Chilean border.,16,0,male_masculine,16,5076
321,450848,common_voice_en_3411.mp3,That's the Philosopher's Stone and the Elixir of Life.,16,0,male_masculine,16,5760
322,760030,common_voice_en_16664.mp3,He had seen the shooting star and was persuaded that a meteorite lay somewhere nearby.,16,0,male_masculine,16,7824
323,450846,common_voice_en_3409.mp3,The idea frightened him.,16,0,male_masculine,16,3432
324,628160,common_voice_en_11811.mp3,He saw the boy appear from the other side of the dunes.,16,0,male_masculine,16,5064
325,1141389,common_voice_en_36827324.mp3,But what did he do?,16,0,male_masculine,16,3024
326,759995,common_voice_en_16629.mp3,He noticed the unequal cooling of its surface.,16,0,male_masculine,16,3888
327,801165,common_voice_en_17201.mp3,"Tomorrow, sell your camel and buy a horse.",16,0,male_masculine,16,3960
328,239939,common_voice_en_30608695.mp3,He is interred at Woodlawn Cemetery in Detroit.,16,0,male_masculine,16,5292
329,508877,common_voice_en_9522.mp3,He stood irresolute for a moment and then scrambled out of the pit.,16,0,male_masculine,16,5064
330,1822619,common_voice_en_31069973.mp3,She previously served as Assistant Chief of Protocol for Visits.,18,2,male_masculine,16,7740
331,450855,common_voice_en_3418.mp3,But none of that mattered to the alchemist.,16,0,male_masculine,16,3792
332,1705075,common_voice_en_37539846.mp3,An ischemic cascade occurs where an energetic molecular problem arises.,16,0,male_masculine,16,9396
333,1826238,common_voice_en_33203944.mp3,The accessible parts include three large rooms with massive pillars.,16,0,male_masculine,16,5796
334,1198250,common_voice_en_38648393.mp3,There is no known genetic link for identical twinning.,16,0,male_masculine,16,4752
335,1141231,common_voice_en_30155920.mp3,There are two main highways in Lewis District.,16,0,male_masculine,16,4968
336,451044,common_voice_en_31503442.mp3,It was later renamed the Central Bureau of Statistics.,18,2,male_masculine,16,5544
337,301235,common_voice_en_1218.mp3,Then he turned to the boy.,17,1,male_masculine,16,3768
338,200885,common_voice_en_36522296.mp3,Crane is depicted as an ambivalent figure.,18,2,male_masculine,16,3708
339,453444,common_voice_en_10654.mp3,It left a greenish streak that glowed for some seconds.,16,0,male_masculine,16,3912
340,859157,common_voice_en_16318.mp3,"At once, he connected the two incidents.",16,0,male_masculine,16,2904
341,453446,common_voice_en_10656.mp3,It spread through the planet's atmosphere and obscured its more familiar features.,18,2,male_masculine,16,4992
342,239937,common_voice_en_30608688.mp3,His daughter married Sir Henry Kitson and was the mother of Sir Frank Kitson.,16,0,male_masculine,16,5940
343,1182301,common_voice_en_30531698.mp3,Today we refer to that criterion as Koch’s postulates.,16,0,male_masculine,16,5220
344,530493,common_voice_en_7872.mp3,But he still couldn't flee.,16,0,male_masculine,16,4296
345,239936,common_voice_en_30608687.mp3,Later in life she developed novel methods to teach mathematics to blind students.,16,0,male_masculine,16,6228
346,1833856,common_voice_en_39436337.mp3,He compiled tosafot to most tractates of the Talmud.,16,0,male_masculine,16,6876
347,239935,common_voice_en_30608686.mp3,The original water tower also remains.,16,0,male_masculine,16,3852
348,776456,common_voice_en_13639.mp3,You were seen at the enemy camp three days ago.,16,0,male_masculine,16,4224
349,772380,common_voice_en_13353.mp3,I myself heard nothing of that.,16,0,male_masculine,16,3072
350,776471,common_voice_en_13655.mp3,"But I'm going to Egypt, the boy said.",17,1,male_masculine,16,4344
351,239934,common_voice_en_30608685.mp3,One prior to the arrival of Gral.,16,0,male_masculine,16,5364
352,780573,common_voice_en_9143.mp3,"There are powerful forces on both sides, and the war is important to both armies.",17,1,male_masculine,16,6936
353,1707473,common_voice_en_38676030.mp3,"Wang, and President Jim Wong, both resigned due to the company's poor financial performance.",18,2,male_masculine,16,9324
354,759984,common_voice_en_16618.mp3,'m all about those invisible cosmic connections that transcend time and distance.,16,0,male_masculine,16,5856
355,780568,common_voice_en_9137.mp3,"You should see the other guy, specifically, how good at fighting he is.",17,1,male_masculine,16,4584
356,1058172,common_voice_en_121114.mp3,Strange images passed through my mind.,17,1,male_masculine,16,3360
357,780532,common_voice_en_9101.mp3,"He arose and, taking up his crook, began to awaken the sheep that still slept.",18,2,male_masculine,16,6744
358,366736,common_voice_en_30614993.mp3,Let’s hope so.,16,0,male_masculine,16,3096
359,239942,common_voice_en_30608699.mp3,She pledged to close the loophole if elected.,16,0,male_masculine,16,5040
360,628169,common_voice_en_11820.mp3,The boy didn't say anything.,17,1,male_masculine,16,2688
361,239941,common_voice_en_30608697.mp3,He played college basketball for Iowa State.,16,0,male_masculine,16,4320
362,628165,common_voice_en_11816.mp3,"At that time, it was quite clear in my own mind that the thing had come from the planet Mars.",17,1,male_masculine,16,7536
363,1174017,common_voice_en_35433460.mp3,His biography is Machiavelli's third famous book on political rule.,16,0,male_masculine,16,5868
364,850694,common_voice_en_30543224.mp3,The first example is an indirect present tense open conditional.,16,0,male_masculine,16,5004
365,239940,common_voice_en_30608696.mp3,They have four children and reside in Huntington.,16,0,male_masculine,16,4140
366,412802,common_voice_en_176.mp3,"It's a dream in the language of the world, she said.",23,7,male_masculine,16,3552
367,453440,common_voice_en_10646.mp3,"The heather was on fire, and you could see a thin blue smoke rising up slowly.",15,0,male_masculine,15,4488
368,453219,common_voice_en_45289.mp3,He just got a new kite for his birthday.,15,0,male_masculine,15,5784
369,303137,common_voice_en_32977.mp3,"It would have been visible to me, had I only looked up as it passed.",16,1,male_masculine,15,4080
370,453441,common_voice_en_10647.mp3,"They looked for the fallen mass, but found nothing.",15,0,male_masculine,15,4296
371,381749,common_voice_en_12246.mp3,"In those days, very few of the people had any idea about astronomy.",15,0,male_masculine,15,5544
372,776442,common_voice_en_13625.mp3,"Let's go and have some lunch, said the crystal merchant.",15,0,male_masculine,15,4056
373,776474,common_voice_en_13658.mp3,I'm going to wait here for you every day.,15,0,male_masculine,15,3936
374,776477,common_voice_en_13661.mp3,The wind told me that you know about love the boy said to the sun.,19,4,male_masculine,15,5616
375,849538,common_voice_en_31067275.mp3,He studied classical archaeology and prehistory at the University of Groningen.,15,0,male_masculine,15,6408
376,776423,common_voice_en_13606.mp3,"You must always know what it is that you want, the old king had said.",15,0,male_masculine,15,8136
377,859056,common_voice_en_16217.mp3,But I didn’t think that it contained any living creature.,15,0,male_masculine,15,3672
378,859075,common_voice_en_16236.mp3,The newspaper articles had prepared everyone for the reception of the idea.,15,0,male_masculine,15,4728
379,849487,common_voice_en_31067011.mp3,Enhancing the relationship bond among the community in the village.,15,0,male_masculine,15,5580
380,548322,common_voice_en_20646.mp3,But he found it much more interesting to observe the caravan and listen to the wind.,16,1,male_masculine,15,5544
381,548299,common_voice_en_20622.mp3,"One day, the earth began to tremble, and the Nile overflowed its banks.",15,0,male_masculine,15,6624
382,849485,common_voice_en_31066985.mp3,A small forestry plantation lies to the southeast of the settlement.,15,0,male_masculine,15,5868
383,449356,common_voice_en_35149898.mp3,"Some games give the player a fifth option, ""surrender"".",15,0,male_masculine,15,4896
384,776446,common_voice_en_13629.mp3,"That's the principle that governs all things, he said.",15,0,male_masculine,15,6144
385,859118,common_voice_en_16279.mp3,The thing itself was almost entirely buried in sand.,15,0,male_masculine,15,3912
386,1145713,common_voice_en_30645528.mp3,Batten supported Braine instead.,15,0,male_masculine,15,3456
387,859088,common_voice_en_16249.mp3,"Coming home, a party of tourists passed us, singing and playing music.",15,0,male_masculine,15,5808
388,450854,common_voice_en_3417.mp3,Some men were smoking from a gigantic pipe that they passed from one to the other.,15,0,male_masculine,15,6360
389,859105,common_voice_en_16266.mp3,"That night, there was another jetting out of gas from the distant planet.",15,0,male_masculine,15,4632
390,776399,common_voice_en_13582.mp3,How do I guess at the future?,16,1,male_masculine,15,3864
391,530480,common_voice_en_7858.mp3,And the sand and gravel had been flung violently in every direction.,15,0,male_masculine,15,5472
392,503410,common_voice_en_13001.mp3,His name was Joseph.,15,0,male_masculine,15,2592
393,331576,common_voice_en_32782.mp3,A large portion of the cylinder had been uncovered.,15,0,male_masculine,15,3768
394,503397,common_voice_en_12988.mp3,"I make my living forecasting the future for people, he said.",15,0,male_masculine,15,4224
395,859097,common_voice_en_16258.mp3,My tax dollars pay for those public school proms.,15,0,male_masculine,15,3456
396,503390,common_voice_en_12981.mp3,"All things are one, the old man had said.",15,0,male_masculine,15,3576
397,859136,common_voice_en_16297.mp3,Absolutely despicable that gingerbread men are forced to live in houses made of their own flesh.,15,0,male_masculine,15,6336
398,849463,common_voice_en_31066852.mp3,Mescal resides in London.,15,0,male_masculine,15,2880
399,776407,common_voice_en_13590.mp3,"So you know about love, the boy said.",15,0,male_masculine,15,4176
400,508883,common_voice_en_9528.mp3,"Many people in Berkshire, Surrey, and Middlesex must have seen it.",16,1,male_masculine,15,4248
401,727108,common_voice_en_21912600.mp3,no,15,0,male_masculine,15,2280
402,628188,common_voice_en_11839.mp3,The oasis is neutral ground.,17,2,male_masculine,15,4752
403,508903,common_voice_en_9548.mp3,"Now, I'm beginning what I could have started ten years ago.",16,1,male_masculine,15,3984
404,1093846,common_voice_en_38741232.mp3,Every member of the family drinks a little of it.,15,0,male_masculine,15,4572
405,772337,common_voice_en_13309.mp3,"If you start your emails with ""Greetings"" let me be the first to welcome you to Earth.",15,0,male_masculine,15,6984
406,772342,common_voice_en_13314.mp3,"Then he dropped his spade, picked up his jacket, and came out into the road.",15,0,male_masculine,15,5520
407,1367862,common_voice_en_32236176.mp3,He visited Delhi and accompanied Emperor Akbar on many of his expeditions.,15,0,male_masculine,15,7920
408,1093766,common_voice_en_38739594.mp3,Hall lived in the area of the Bethany Church.,15,0,male_masculine,15,4428
409,780596,common_voice_en_9166.mp3,But he decided to take a chance.,15,0,male_masculine,15,2784
410,955766,common_voice_en_38568346.mp3,Neglect was exacerbated by his own increasing reclusiveness and hostility to the learned societies.,15,0,male_masculine,15,7704
411,772389,common_voice_en_13362.mp3,Then came the night of the first falling star.,15,0,male_masculine,15,3624
412,772353,common_voice_en_13325.mp3,"Why the shots stopped after the tenth, no one on earth has tried to explain.",15,0,male_masculine,15,6216
413,772383,common_voice_en_13356.mp3,The turf and gravel around it seemed charred as if by a sudden explosion.,15,0,male_masculine,15,5664
414,772354,common_voice_en_13326.mp3,"Hundreds must have seen it, and taken it for a falling star.",15,0,male_masculine,15,4800
415,772346,common_voice_en_13318.mp3,Then the thing came upon him in a flash.,16,1,male_masculine,15,4344
416,780540,common_voice_en_9109.mp3,"The dunes are changed by the wind, but the desert never changes.",15,0,male_masculine,15,4824
417,772331,common_voice_en_13303.mp3,I'm never more aware of a room's acoustics than when I'm trying to enjoy a snack I have no intention of sharing.,16,1,male_masculine,15,6984
418,780566,common_voice_en_9135.mp3,"They mounted their horses, and rode out in the direction of the Pyramids of Egypt.",15,0,male_masculine,15,5064
419,1093812,common_voice_en_38740535.mp3,"In Pissouri there are several shops, and many tavernas, restaurants and bars.",20,5,male_masculine,15,6876
420,1093826,common_voice_en_38740608.mp3,She became secretary of the Chamber.,15,0,male_masculine,15,4428
421,381755,common_voice_en_12255.mp3,I locked eyes with a fish in the tank.,15,0,male_masculine,15,3384
422,301231,common_voice_en_1214.mp3,"In his hand, he grasped a snake by the tail.",16,1,male_masculine,15,5520
423,301112,common_voice_en_9805.mp3,It looked like a rusty gas float.,18,3,male_masculine,15,3024
424,784846,common_voice_en_32372078.mp3,The Malaysian Ministry of Education is in charge of it.,15,0,male_masculine,15,4860
425,784849,common_voice_en_32372081.mp3,Each of these tournaments offers different ranking points and prize money.,15,0,male_masculine,15,6228
426,784858,common_voice_en_32372090.mp3,Lily May and Cybele Ethel were born while the family was living in Auckland.,15,0,male_masculine,15,7308
427,784867,common_voice_en_32372119.mp3,He serves on the Advisory Council of the Climate Museum.,15,0,male_masculine,15,5436
428,37798,common_voice_en_18691.mp3,The time must have been somewhere around six o'clock.,15,0,male_masculine,15,3960
429,381752,common_voice_en_12252.mp3,It's extremely suspicious that there's no information about brains that didn't come from a brain.,17,2,male_masculine,15,5664
430,301230,common_voice_en_1213.mp3,It seemed he had made the long journey for nothing.,15,0,male_masculine,15,5448
431,1093752,common_voice_en_38739492.mp3,This twist of history altered Tuskahoma's prominence.,15,0,male_masculine,15,5328
432,508893,common_voice_en_9538.mp3,"He came to understand its dodges and tricks, and to accept it as it was.",15,0,male_masculine,15,5736
433,628170,common_voice_en_11821.mp3,"If what one finds is made of pure matter, it will never spoil.",17,2,male_masculine,15,4440
434,508884,common_voice_en_9529.mp3,They formed heaps that are visible a mile and a half away.,15,0,male_masculine,15,3816
435,1093960,common_voice_en_38745248.mp3,Links are coordinated by Epsom and Ewell Town Twinning Association.,15,0,male_masculine,15,5904
436,772408,common_voice_en_13381.mp3,I thought about the difficulties in translation that might arise.,15,0,male_masculine,15,4512
437,760038,common_voice_en_16672.mp3,Henderson went into the railway station to telegraph the news to London.,15,0,male_masculine,15,4512
438,780518,common_voice_en_9086.mp3,The top had certainly ceased to rotate.,15,1,male_masculine,14,3456
439,1827867,common_voice_en_35509057.mp3,Three of them received the death penalty.,14,0,male_masculine,14,4320
440,385766,common_voice_en_24529.mp3,"Coming home, a party of tourists passed us, singing and playing music.",14,0,male_masculine,14,4416
441,1823100,common_voice_en_31396268.mp3,His photojournalism has mostly been made in Brazil and Kenya.,14,0,male_masculine,14,6948
442,530478,common_voice_en_7856.mp3,That's why I feel that I deserve a part of what you find.,15,1,male_masculine,14,5400
443,628175,common_voice_en_11826.mp3,Only in that way would he be able to read the omens.,16,2,male_masculine,14,4944
444,1278433,common_voice_en_20285765.mp3,The Tyson Turbine is a very common way to reuse energy.,14,0,male_masculine,14,6048
445,780537,common_voice_en_9106.mp3,We lit the lantern and walked over to his house.,15,1,male_masculine,14,2976
446,628198,common_voice_en_11849.mp3,And the names of the people involved were very difficult to pronounce.,15,1,male_masculine,14,5256
447,1251441,common_voice_en_35060127.mp3,It refers to Jesus Christ.,14,0,male_masculine,14,2484
448,772350,common_voice_en_13322.mp3,"I thought about whether we should find coins and models in it, and so on.",15,1,male_masculine,14,5016
449,453458,common_voice_en_10669.mp3,They had gone away to breakfast at Henderson's house.,16,2,male_masculine,14,3696
450,1829802,common_voice_en_36658080.mp3,"They were drawn with Asia's Queen Australia, host Vietnam and newcomer Jordan.",14,0,male_masculine,14,6516
451,1830597,common_voice_en_36918903.mp3,The duty of tending the fire passes to his eldest wife.,14,0,male_masculine,14,5868
452,1707556,common_voice_en_38692404.mp3,Reviewers were positive.,16,2,male_masculine,14,2880
453,28235,common_voice_en_9443.mp3,"Because my eyes are not yet accustomed to the desert, the boy said.",15,1,male_masculine,14,4680
454,628156,common_voice_en_11807.mp3,The Soul of the World is nourished by people's happiness.,14,0,male_masculine,14,4656
455,1705779,common_voice_en_38235150.mp3,"Foundries, mills, furniture assembly, meat processing, nail and wire factories were established.",20,6,male_masculine,14,8928
456,453435,common_voice_en_10640.mp3,But I didn’t think that it contained any living creature.,16,2,male_masculine,14,3024
457,1251484,common_voice_en_35060320.mp3,Cardew has supported almost twenty years of the Royal Institution Christmas Lectures.,14,0,male_masculine,14,5328
458,772334,common_voice_en_13306.mp3,"It was, however, still so hot from its flight through the air.",14,0,male_masculine,14,5064
459,780557,common_voice_en_9126.mp3,And the odor of the animals became a bit more tolerable.,16,2,male_masculine,14,3336
460,772404,common_voice_en_13377.mp3,There was very little talking.,14,0,male_masculine,14,2352
461,776429,common_voice_en_13612.mp3,"If someone isn't what others want them to be, the others become angry.",14,0,male_masculine,14,7224
462,776416,common_voice_en_13599.mp3,The boy observed in silence the progress of the animals and people across the desert.,14,0,male_masculine,14,7176
463,780593,common_voice_en_9163.mp3,"But, just before lunchtime, a boy stopped in front of the shop.",15,1,male_masculine,14,4656
464,780594,common_voice_en_9164.mp3,"We don't know when the war will end, so we can't continue our journey, he said.",14,0,male_masculine,14,5664
465,776396,common_voice_en_13579.mp3,The sheep had taught him that.,15,1,male_masculine,14,3144
466,780595,common_voice_en_9165.mp3,That he wanted to travel.,14,0,male_masculine,14,1944
467,1357290,common_voice_en_32422853.mp3,He was the younger brother of Alexander Bethune.,14,0,male_masculine,14,4896
468,780597,common_voice_en_9167.mp3,"They are so used to me that they know my schedule, he muttered.",16,2,male_masculine,14,4464
469,301229,common_voice_en_1212.mp3,He decided to return to his friend's stable by the longest route possible.,16,2,male_masculine,14,5448
470,503392,common_voice_en_12983.mp3,"He almost began to tell about his treasure, but decided not to do so.",14,0,male_masculine,14,4872
471,772407,common_voice_en_13380.mp3,He got up early with the idea of finding it.,15,1,male_masculine,14,3312
472,1703924,common_voice_en_35098009.mp3,The election was won by Mahmud Kanti Bello of the Peoples Democratic Party.,16,2,male_masculine,14,8136
473,1044629,common_voice_en_18875.mp3,He had helped him out in a dangerous situation.,14,0,male_masculine,14,3864
474,1830008,common_voice_en_36814060.mp3,There are numerous variations in completing the Four Thousand Footer list.,14,0,male_masculine,14,6156
475,1704529,common_voice_en_37253846.mp3,"Grand Canyon National Park categorizes the Bright Angel Trail as a ""corridor trail"".",18,4,male_masculine,14,8388
476,1828897,common_voice_en_36436339.mp3,The Double Dragon has no hold upon the mere form.,14,0,male_masculine,14,5112
477,456731,common_voice_en_31598.mp3,They had gone away to breakfast at Henderson's house.,14,0,male_masculine,14,4224
478,1704237,common_voice_en_36555726.mp3,This will cease when the spacebar is released.,14,0,male_masculine,14,6120
479,958154,common_voice_en_99519.mp3,"If I'm on the march, I just concentrate on marching.",14,0,male_masculine,14,4104
480,772391,common_voice_en_13364.mp3,Absolutely despicable that gingerbread men are forced to live in houses made of their own flesh.,14,0,male_masculine,14,7056
481,780526,common_voice_en_9094.mp3,And he hadn't perceived them because he had become accustomed to them.,15,1,male_masculine,14,4104
482,780529,common_voice_en_9097.mp3,"I was scared, but wasted no time in going out and crossing the bridge to the sand pits.",17,3,male_masculine,14,5616
483,780530,common_voice_en_9099.mp3,"His heart squeezed, as if his chest had suddenly compressed it.",16,2,male_masculine,14,4176
484,859069,common_voice_en_16230.mp3,"Then he dropped his spade, picked up his jacket, and came out into the road.",15,1,male_masculine,14,4128
485,780571,common_voice_en_9141.mp3,"I wanted to sleep a little longer, he thought.",15,1,male_masculine,14,3216
486,12700,common_voice_en_39353057.mp3,"A few weeks later, Henry reverses his opinion, but it's too late.",14,0,male_masculine,14,6408
487,772347,common_voice_en_13319.mp3,It had a diameter of about thirty yards.,14,0,male_masculine,14,3504
488,772381,common_voice_en_13354.mp3,So how will we name all these hurricanes?,14,0,male_masculine,14,3312
489,776453,common_voice_en_13636.mp3,Then he turned to the boy.,14,0,male_masculine,14,3384
490,772387,common_voice_en_13360.mp3,"From the railway station in the distance came the sound of trains, ringing and rumbling.",14,0,male_masculine,14,6144
491,167807,common_voice_en_10058.mp3,And that's where the power of love comes in.,14,0,male_masculine,14,4224
492,772360,common_voice_en_13333.mp3,"Before guns were invented, armies had to throw bullets at each other and if a bullet touched you, you had to sit out until the next war.",14,0,male_masculine,14,8064
493,776424,common_voice_en_13607.mp3,"Like everybody learns, he said.",14,0,male_masculine,14,4056
494,780549,common_voice_en_9118.mp3,And one can always come back.,17,3,male_masculine,14,1824
495,776420,common_voice_en_13603.mp3,I heard a faint movement under my feet.,14,0,male_masculine,14,4536
496,776448,common_voice_en_13631.mp3,But he's on the right track.,14,0,male_masculine,14,2784
497,780589,common_voice_en_9159.mp3,And he decided he would go to see the chiefs of the tribes.,14,0,male_masculine,14,3216
498,167806,common_voice_en_10057.mp3,"The old man wore a breastplate of heavy gold, covered with precious stones.",14,0,male_masculine,14,6624
499,780563,common_voice_en_9132.mp3,"I noticed that, the boy answered.",15,1,male_masculine,14,3024
500,780603,common_voice_en_9173.mp3,And the names of the people involved were very difficult to pronounce.,15,1,male_masculine,14,3936
501,776445,common_voice_en_13628.mp3,"The wind screamed with delight, and blew harder than ever.",14,0,male_masculine,14,5784
502,780548,common_voice_en_9117.mp3,The alchemist followed as the boy's horse ran for almost half an hour.,16,2,male_masculine,14,4344
503,301237,common_voice_en_1220.mp3,He left without saying good-bye to the crystal merchant.,15,1,male_masculine,14,3528
504,204961,common_voice_en_11867.mp3,"She would never know the difference, because she didn't know how to read.",14,0,male_masculine,14,4584
505,801188,common_voice_en_17224.mp3,Then one day the boy returned the books to the Englishman.,14,0,male_masculine,14,3408
506,466539,common_voice_en_10484.mp3,"You can't be the wind, the wind said.",14,0,male_masculine,14,4776
507,450839,common_voice_en_3402.mp3,"His hands began to tremble, and the woman sensed it.",14,0,male_masculine,14,7512
508,450840,common_voice_en_3403.mp3,"He is going to transform himself into the wind, just to demonstrate his powers.",14,0,male_masculine,14,6816
509,399048,common_voice_en_75346.mp3,"When I returned to the common, the sun was setting.",14,0,male_masculine,14,3792
510,204964,common_voice_en_11870.mp3,A card hanging in the doorway announced that several languages were spoken in the shop.,14,0,male_masculine,14,5544
511,1824626,common_voice_en_32110090.mp3,He also promoted missions in Asia and Eastern Europe.,14,0,male_masculine,14,4968
512,450849,common_voice_en_3412.mp3,This is for you.,14,0,male_masculine,14,4248
513,450850,common_voice_en_3413.mp3,The boy told him then that he needed to get to the Pyramids.,14,0,male_masculine,14,4992
514,450851,common_voice_en_3414.mp3,He said that everything has its own destiny.,14,0,male_masculine,14,6072
515,1706835,common_voice_en_38523717.mp3,"He was succeeded by his eldest son, Harold.",14,0,male_masculine,14,4392
516,329750,common_voice_en_3504.mp3,Even when all you want to do is travel?,14,0,male_masculine,14,4632
517,381757,common_voice_en_12257.mp3,I heard a peculiar humming sound from the pit.,15,1,male_masculine,14,3336
518,203306,common_voice_en_49230.mp3,And then he perceived it very slowly.,14,0,male_masculine,14,3984
519,204957,common_voice_en_11863.mp3,"When the sun sets, the men will once again surrender their arms to me.",14,0,male_masculine,14,5184
520,1180056,common_voice_en_24240.mp3,"On the first day he returned with a rabbit, and on the second with two birds.",14,0,male_masculine,14,4920
521,1183316,common_voice_en_25715058.mp3,Culture was the grounding concept and orchestrating principle for its courses.,16,2,male_masculine,14,4536
522,1833697,common_voice_en_38776554.mp3,What does the conclusion of the Lord’s Prayer teach us?,14,0,male_masculine,14,5436
523,1238420,common_voice_en_36736019.mp3,Nominations are chosen by triple j management and are released throughout the year.,14,0,male_masculine,14,4644
524,772352,common_voice_en_13324.mp3,The night was warm and I was thirsty.,14,1,male_masculine,13,3144
525,772398,common_voice_en_13371.mp3,The loafers and golf caddies were used to hanging out near the railway station.,14,1,male_masculine,13,5376
526,776427,common_voice_en_13610.mp3,I told you that your dream was a difficult one.,13,0,male_masculine,13,4056
527,859137,common_voice_en_16298.mp3,A line of flame high can be seen in the atmosphere.,13,0,male_masculine,13,3504
528,776394,common_voice_en_13577.mp3,He really was a king!,13,0,male_masculine,13,2904
529,780536,common_voice_en_9105.mp3,"If I don't find it, I can always go home.",13,0,male_masculine,13,3576
530,1316510,common_voice_en_20286336.mp3,You never see that nowadays; those tinctures are never prescribed.,13,0,male_masculine,13,6432
531,453448,common_voice_en_10658.mp3,"It seemed such a little thing, so bright and small and still.",14,1,male_masculine,13,3960
532,167809,common_voice_en_10060.mp3,"The omens will begin insistently to speak of it, and you'll try to ignore them.",14,1,male_masculine,13,6528
533,776413,common_voice_en_13596.mp3,"Rest well tonight, as if you were a warrior preparing for combat.",13,0,male_masculine,13,7416
534,453450,common_voice_en_10660.mp3,I went stretching my legs clumsily and feeling my way in the dark.,13,0,male_masculine,13,3888
535,776469,common_voice_en_13653.mp3,The conversation was interrupted by the warehouse boss.,13,0,male_masculine,13,4584
536,776397,common_voice_en_13580.mp3,"I'll be back, the boy said.",15,2,male_masculine,13,3456
537,760014,common_voice_en_16648.mp3,Absolutely despicable that gingerbread men are forced to live in houses made of their own flesh.,13,0,male_masculine,13,5256
538,759980,common_voice_en_16614.mp3,"Coming home, a party of tourists passed us, singing and playing music.",13,0,male_masculine,13,4704
539,776441,common_voice_en_13624.mp3,He noticed the unequal cooling of its surface.,13,0,male_masculine,13,5736
540,450853,common_voice_en_3416.mp3,"There are many languages spoken by things, the boy said.",13,0,male_masculine,13,4848
541,776452,common_voice_en_13635.mp3,"First, they tried to find him on their own.",13,0,male_masculine,13,3864
542,503409,common_voice_en_13000.mp3,"He loosened the reins on his horse, who galloped forward over the rocks and sand.",13,0,male_masculine,13,6024
543,776473,common_voice_en_13657.mp3,Where is the treasure? he asked.,14,1,male_masculine,13,3624
544,503404,common_voice_en_12995.mp3,"Those are the rules of war, the leader explained.",14,1,male_masculine,13,3960
545,503401,common_voice_en_12992.mp3,The boy took them to the cliff where he had been on the previous day.,13,0,male_masculine,13,4344
546,503398,common_voice_en_12989.mp3,Some of the grey ash was falling off the circular edge.,14,1,male_masculine,13,4920
547,491877,common_voice_en_36710.mp3,Everyone seemed very excited.,13,0,male_masculine,13,2736
548,453449,common_voice_en_10659.mp3,"Yet, it was a little too large for assurance.",13,0,male_masculine,13,3144
549,780527,common_voice_en_9095.mp3,"Half an hour later, his shovel hit something solid.",17,4,male_masculine,13,3144
550,700207,common_voice_en_20214.mp3,"You are almost at the end of your journey, said the alchemist.",13,0,male_masculine,13,3552
551,272872,common_voice_en_15944.mp3,He heard a muffled grating sound and saw the black mark jerk forward an inch or so.,15,2,male_masculine,13,5952
552,780528,common_voice_en_9096.mp3,"I'd like to build a display case for the crystal, the boy said to the merchant.",14,1,male_masculine,13,5064
553,530506,common_voice_en_7885.mp3,He should respect tradition.,13,0,male_masculine,13,3504
554,776444,common_voice_en_13627.mp3,It was the old man who spoke first.,14,1,male_masculine,13,3504
555,1319473,common_voice_en_513974.mp3,"Forthwith flashes of actual flame, a bright glare leaping from one to another, sprang from the scattered group of men.",15,2,male_masculine,13,9384
556,450834,common_voice_en_3397.mp3,"Maybe tomorrow, said the boy, moving away.",13,0,male_masculine,13,4824
557,450836,common_voice_en_3399.mp3,"He followed the movement of the birds, trying to read something into it.",14,1,male_masculine,13,6816
558,859102,common_voice_en_16263.mp3,"In those days, very few of the people had any idea about astronomy.",13,0,male_masculine,13,5424
559,167808,common_voice_en_10059.mp3,"He dressed in his Arabian clothing of white linen, bought especially for this day.",13,0,male_masculine,13,6480
560,772332,common_voice_en_13304.mp3,"Of course, the two were unable to do anything.",13,0,male_masculine,13,4008
561,780531,common_voice_en_9100.mp3,"Good-bye, said the boy.",13,0,male_masculine,13,2304
562,204958,common_voice_en_11864.mp3,Only the lights in the great tent remained.,13,0,male_masculine,13,5304
563,530485,common_voice_en_7864.mp3,"You can't go any farther, one of them said.",13,0,male_masculine,13,4224
564,450837,common_voice_en_3400.mp3,"From there, he could see Africa in the distance.",14,1,male_masculine,13,3888
565,272867,common_voice_en_15939.mp3,All that time the Martians must have been getting ready.,14,1,male_masculine,13,3144
566,772358,common_voice_en_13330.mp3,But I found it difficult to get to work because of the investigations.,13,0,male_masculine,13,4512
567,772356,common_voice_en_13328.mp3,"About eleven, I walked back to my home in Maybury because nothing seemed to be happening.",13,0,male_masculine,13,6144
568,776430,common_voice_en_13613.mp3,"The gods should not have desires, because they don't have destinies.",13,0,male_masculine,13,6624
569,450838,common_voice_en_3401.mp3,Don't say that again.,13,0,male_masculine,13,3168
570,412791,common_voice_en_164.mp3,And the sand and gravel had been flung violently in every direction.,21,8,male_masculine,13,5088
571,530477,common_voice_en_7855.mp3,The old woman had said the same thing.,13,0,male_masculine,13,6072
572,859126,common_voice_en_16287.mp3,You point to a trail of ants leading into the house.,13,0,male_masculine,13,3576
573,530492,common_voice_en_7871.mp3,"After all, he had all his money.",13,0,male_masculine,13,4272
574,863744,common_voice_en_17414525.mp3,What does it all mean?,13,0,male_masculine,13,1680
575,772345,common_voice_en_13317.mp3,The newspaper articles had prepared everyone for the reception of the idea.,13,0,male_masculine,13,4992
576,450842,common_voice_en_3405.mp3,Scattered groups of people were hurrying from the direction of Woking.,13,0,male_masculine,13,7512
577,772330,common_voice_en_13302.mp3,It was dropping off in flakes and raining down on the sand.,13,0,male_masculine,13,4704
578,859143,common_voice_en_16304.mp3,Even then he hardly understood what this meant.,13,0,male_masculine,13,4128
579,301111,common_voice_en_9804.mp3,He got up early with the idea of finding it.,13,0,male_masculine,13,3744
580,759974,common_voice_en_16608.mp3,I found a little crowd of about twenty people surrounding the huge hole.,13,0,male_masculine,13,4368
581,859148,common_voice_en_16309.mp3,The two men hurried back and found the cylinder still lying in the same position.,13,0,male_masculine,13,5016
582,628191,common_voice_en_11842.mp3,"All they ever do, really, is look for food and water.",17,4,male_masculine,13,5784
583,628193,common_voice_en_11844.mp3,How did you learn to read? the girl asked at one point.,13,0,male_masculine,13,3792
584,759969,common_voice_en_16603.mp3,"Revenge is not my style, but obviously accidents will happen.",13,0,male_masculine,13,4248
585,453211,common_voice_en_45281.mp3,My mind ran on the possibilities of its content.,13,0,male_masculine,13,5040
586,140221,common_voice_en_12940.mp3,I found a little crowd of about twenty people surrounding the huge hole.,13,0,male_masculine,13,5184
587,172899,common_voice_en_11184.mp3,"That's the way it always is, said the old man.",15,2,male_masculine,13,4824
588,381745,common_voice_en_12241.mp3,"I pointed out Mars, a bright dot of light.",13,0,male_masculine,13,3264
589,1044626,common_voice_en_18872.mp3,"We're refugees from the tribal wars, and we need money, the other figure said.",13,0,male_masculine,13,5664
590,508876,common_voice_en_9521.mp3,"Sometimes it's better to be with the sheep, who don't say anything.",13,0,male_masculine,13,4224
591,508878,common_voice_en_9523.mp3,Don't ask me why; I don't know why.,14,1,male_masculine,13,3696
592,859159,common_voice_en_16320.mp3,I thought about the difficulties in translation that might arise.,13,0,male_masculine,13,4224
593,594909,common_voice_en_41668.mp3,They had gone away to breakfast at Henderson's house.,13,0,male_masculine,13,3840
594,859163,common_voice_en_16324.mp3,The streamer of gas came out towards us.,13,0,male_masculine,13,2952
595,801164,common_voice_en_17200.mp3,He was sure the girl would never understand.,13,0,male_masculine,13,2904
596,381742,common_voice_en_12237.mp3,"If you start your emails with ""Greetings"" let me be the first to welcome you to Earth.",14,1,male_masculine,13,6264
597,354036,common_voice_en_35281.mp3,I would have won the Junior Olympics if not for those medaling kids.,13,0,male_masculine,13,4704
598,508894,common_voice_en_9539.mp3,"This is why alchemy exists, the boy said.",13,0,male_masculine,13,4512
599,354045,common_voice_en_35290.mp3,I locked eyes with a fish in the tank.,13,0,male_masculine,13,3288
600,503389,common_voice_en_12980.mp3,But they don't count.,13,0,male_masculine,13,2208
601,628174,common_voice_en_11825.mp3,The old man said nothing.,15,2,male_masculine,13,3240
602,508881,common_voice_en_9526.mp3,But he appeared to be unaware of any danger.,13,0,male_masculine,13,4512
603,451580,common_voice_en_17043.mp3,The wind began to blow again.,13,0,male_masculine,13,2304
604,508889,common_voice_en_9534.mp3,"He got up, adjusted his clothing, and picked up his pouch.",13,0,male_masculine,13,5088
605,801193,common_voice_en_17229.mp3,"At the highest point in Tarifa there is an old fort, built by the Moors.",13,0,male_masculine,13,6264
606,453220,common_voice_en_45290.mp3,"My wife pointed out to me the brightness of the red, green, and yellow signal lights.",13,0,male_masculine,13,7344
607,172902,common_voice_en_11187.mp3,"I wanted to sleep a little longer, he thought.",13,0,male_masculine,13,3696
608,628181,common_voice_en_11832.mp3,He heard a muffled grating sound and saw the black mark jerk forward an inch or so.,17,4,male_masculine,13,6336
609,772385,common_voice_en_13358.mp3,"We don't know what's in the confounded thing, do you?",13,0,male_masculine,13,4248
610,450856,common_voice_en_3419.mp3,"Instead, the stranger lowered it slowly, until the point touched the boy's forehead.",13,0,male_masculine,13,8688
611,323513,common_voice_en_8600.mp3,The little group of people from the city dispersed.,13,0,male_masculine,13,4176
612,668335,common_voice_en_30569395.mp3,Mila made his way west towards the Dungu River.,12,0,male_masculine,12,4680
613,33658,common_voice_en_38865706.mp3,"According to Koschorke, Martin supported colonial expansion.",12,0,male_masculine,12,6696
614,381747,common_voice_en_12243.mp3,"They looked for the fallen mass, but found nothing.",12,0,male_masculine,12,3864
615,272871,common_voice_en_15943.mp3,"The shop folks were taking down their shutters, and people were opening their bedroom windows.",12,0,male_masculine,12,8232
616,322005,common_voice_en_30232728.mp3,The economic activity of the Pampas district is not oriented to tourism.,12,0,male_masculine,12,6732
617,306440,common_voice_en_16155.mp3,I'm going to them.,13,1,male_masculine,12,1944
618,1706964,common_voice_en_38530595.mp3,He has conducted the Estonian Song Festival on numerous occasions.,12,0,male_masculine,12,7416
619,780547,common_voice_en_9116.mp3,That it was unable to deal with this boy who spoke the Language of the World.,16,4,male_masculine,12,5736
620,840533,common_voice_en_32755805.mp3,All Somalis support you in this.,12,0,male_masculine,12,2808
621,1182437,common_voice_en_30536453.mp3,Darling Range Sports College is the first specialist sports school in Western Australia.,16,4,male_masculine,12,6660
622,548326,common_voice_en_20651.mp3,"Well, then, we've got a problem.",13,1,male_masculine,12,2520
623,1044755,common_voice_en_19005.mp3,"This is why alchemy exists, the boy said.",12,0,male_masculine,12,3864
624,1182452,common_voice_en_30536498.mp3,He was born and died in Philadelphia.,12,0,male_masculine,12,3888
625,776439,common_voice_en_13622.mp3,"The old man wore a breastplate of gold, and he knew about my past.",12,0,male_masculine,12,5544
626,700208,common_voice_en_20215.mp3,"I'll work all night, until dawn, and I'll clean every piece of crystal in your shop.",12,0,male_masculine,12,4608
627,1182455,common_voice_en_30536501.mp3,He trained in the workshop of Bartolomeo Manfredi.,12,0,male_masculine,12,5256
628,355679,common_voice_en_18043.mp3,"The heather was on fire, and you could see a thin blue smoke rising up slowly.",12,0,male_masculine,12,5064
629,840600,common_voice_en_32756986.mp3,All: Thanks be to God!,12,0,male_masculine,12,3060
630,776459,common_voice_en_13642.mp3,He left without saying good-bye to the crystal merchant.,13,1,male_masculine,12,4224
631,469369,common_voice_en_32870361.mp3,It was produced by John Walker.,12,0,male_masculine,12,3168
632,957096,common_voice_en_37679399.mp3,He lives on today as a constellation and an inspiration.,12,0,male_masculine,12,4752
633,1367797,common_voice_en_32235031.mp3,It was their first ever championship title in this grade.,12,0,male_masculine,12,4176
634,1238250,common_voice_en_36735413.mp3,The type of climb is therefore determined by the pitch attitude.,12,0,male_masculine,12,3996
635,776450,common_voice_en_13633.mp3,"A current of love rushed from his heart, and the boy began to pray.",12,0,male_masculine,12,4776
636,1829921,common_voice_en_36677862.mp3,Her sister Tina and cousin Chad are also curlers.,12,0,male_masculine,12,5436
637,1160271,common_voice_en_17580857.mp3,"The results of the test were inconclusive, and it has not been repeated.",12,0,male_masculine,12,4248
638,1231849,common_voice_en_36891912.mp3,Wise thus waived the right to further appeals of his death sentence.,12,0,male_masculine,12,5436
639,1562298,common_voice_en_20675189.mp3,Soviet law emphasized economic and social rights over civil and political rights.,12,0,male_masculine,12,4656
640,780559,common_voice_en_9128.mp3,"Maybe we'd better ask someone, the boy suggested.",15,3,male_masculine,12,3576
641,776461,common_voice_en_13644.mp3,He approached the mass and was surprised at the size and the shape.,12,0,male_masculine,12,5544
642,1665846,common_voice_en_29381005.mp3,"She was raised just outside Mariefred, Sweden.",12,0,male_masculine,12,5580
643,1044668,common_voice_en_18915.mp3,"One afternoon, one of his servants fell ill, and it appeared that he would die.",12,0,male_masculine,12,5376
644,381760,common_voice_en_12263.mp3,It was no more exciting than an overturned carriage or a tree blown across the road.,15,3,male_masculine,12,5544
645,1044694,common_voice_en_18943.mp3,The man wept with happiness.,12,0,male_masculine,12,3216
646,503416,common_voice_en_13007.mp3,The boy was also saddened; his friend was in pursuit of his destiny.,13,1,male_masculine,12,5352
647,503414,common_voice_en_13005.mp3,"But none of that is from the Pyramids, said the alchemist.",12,0,male_masculine,12,4080
648,329748,common_voice_en_3502.mp3,Servants came and went with silver trays laden with spices and tea.,12,0,male_masculine,12,7344
649,329744,common_voice_en_3498.mp3,"I need to sell some wool, the boy told the merchant.",13,1,male_masculine,12,5112
650,911792,common_voice_en_36383446.mp3,"Three pairs, if you please.",12,0,male_masculine,12,3924
651,1827129,common_voice_en_34939339.mp3,Examples of primary alcohols include ethanol and butanol.,16,4,male_masculine,12,7128
652,796186,common_voice_en_31094541.mp3,Another main commonality in both Sunni and Shi’i groups is Sufism.,12,0,male_masculine,12,6552
653,1455311,common_voice_en_35193336.mp3,"The West Florida government opposed annexation, preferring to negotiate terms to join the Union.",12,0,male_masculine,12,6588
654,1158003,common_voice_en_44966.mp3,I'm going to them.,12,0,male_masculine,12,1224
655,503391,common_voice_en_12982.mp3,"On the third day, the chief met with his officers.",12,0,male_masculine,12,3336
656,1704612,common_voice_en_37256631.mp3,"A born-again Canadian exobiologist, Gerald was transported to the Multisystem along with the Earth.",12,0,male_masculine,12,8496
657,1589893,common_voice_en_18352508.mp3,The existence of gravitational waves had long been predicted.,12,0,male_masculine,12,5496
658,796201,common_voice_en_31098567.mp3,It was shot in Eastmancolor.,12,0,male_masculine,12,3348
659,596135,common_voice_en_31966041.mp3,The series is produced jointly by Tencent Penguin Pictures and Otters Studio.,12,0,male_masculine,12,6264
660,612398,common_voice_en_32274733.mp3,Demenevo is the nearest rural locality.,12,0,male_masculine,12,6012
661,663253,common_voice_en_12841.mp3,The boy was surprised.,12,0,male_masculine,12,3024
662,323502,common_voice_en_8589.mp3,But he certainly didn't desire that an army invade the oasis.,12,0,male_masculine,12,4464
663,323506,common_voice_en_8593.mp3,"He knew what I was thinking, the boy said to himself.",12,0,male_masculine,12,4656
664,776410,common_voice_en_13593.mp3,"There is a universal language, understood by everybody, but already forgotten.",12,0,male_masculine,12,7464
665,741226,common_voice_en_38503122.mp3,It is operated as part of the Florida's Turnpike Enterprise system of limited-access expressways.,12,0,male_masculine,12,7200
666,780575,common_voice_en_9145.mp3,"No, he heard a voice on the wind say.",15,3,male_masculine,12,3816
667,768308,common_voice_en_21020.mp3,The guy thought he was a lunatic at large and made an unsuccessful attempt to stop him.,12,0,male_masculine,12,5424
668,768311,common_voice_en_21023.mp3,"The stranger withdrew the sword from the boy's forehead, and the boy felt immensely relieved.",12,0,male_masculine,12,7008
669,501260,common_voice_en_85930.mp3,I was disappointed at this inanimate bulk.,12,0,male_masculine,12,4776
670,1833615,common_voice_en_38667595.mp3,They are remembered by the naming of places and streets along the waterfront.,12,0,male_masculine,12,5940
671,176648,common_voice_en_37991121.mp3,Dudley's parentage has never been satisfactorily established.,12,0,male_masculine,12,6912
672,470829,common_voice_en_43131.mp3,Then came the night of the first falling star.,12,0,male_masculine,12,2496
673,303134,common_voice_en_32974.mp3,Some storms are worth the wreckage.,12,0,male_masculine,12,3072
674,1369011,common_voice_en_36551699.mp3,Thionyl chloride converts phosphonic acids and phosphonates into phosphoryl chlorides.,12,0,male_masculine,12,7632
675,274548,common_voice_en_2136.mp3,Not until the moon was high did the alchemist ride into view.,17,5,male_masculine,12,5208
676,596143,common_voice_en_31966064.mp3,Mallinson.,12,0,male_masculine,12,2268
677,776401,common_voice_en_13584.mp3,"The sun began its departure, as well.",13,1,male_masculine,12,3744
678,1706888,common_voice_en_38529039.mp3,"It lies in the Mare Insularum, to the northeast of the crater Reinhold.",12,0,male_masculine,12,7128
679,1285701,common_voice_en_31502065.mp3,Songs on side two of the album remain unreleased elsewhere.,12,0,male_masculine,12,5400
680,1180288,common_voice_en_24476.mp3,The boy remembered an old proverb from his country.,12,0,male_masculine,12,4680
681,508880,common_voice_en_9525.mp3,He decided to return to his friend's stable by the longest route possible.,13,1,male_masculine,12,4512
682,628197,common_voice_en_11848.mp3,Don't forget that everything you deal with is only one thing and nothing else.,12,0,male_masculine,12,4512
683,628199,common_voice_en_11850.mp3,The shop is exactly the size I always wanted it to be.,12,0,male_masculine,12,4512
684,859164,common_voice_en_16325.mp3,It looked like a rusty gas float.,12,0,male_masculine,12,3984
685,546619,common_voice_en_37838788.mp3,Anani was born in Minnesota and raised in Kansas.,12,0,male_masculine,12,5580
686,843919,common_voice_en_11975.mp3,Because now he knew where his treasure was.,12,0,male_masculine,12,4680
687,546620,common_voice_en_37838807.mp3,He was educated at Ampleforth College in North Yorkshire.,12,0,male_masculine,12,5148
688,546587,common_voice_en_37838667.mp3,While in Eltham he was a member of the Priory Players amateur dramatics group.,12,0,male_masculine,12,6912
689,1218931,common_voice_en_35021834.mp3,Stormy Monday was a favorite live number of the Allman Brothers Band.,12,0,male_masculine,12,6948
690,546616,common_voice_en_37838782.mp3,"Advanced Dungeons and Dragons eliminated dependencies on ""Chainmail"" entirely.",12,0,male_masculine,12,7632
691,546613,common_voice_en_37838740.mp3,This method works by dividing the long sequence into several consecutive short ones.,12,0,male_masculine,12,7848
692,1704058,common_voice_en_36493733.mp3,After each verse he imitates the cry and action of the animal.,12,0,male_masculine,12,7236
693,672921,common_voice_en_32431449.mp3,Village chiefs denied the decision as being politically motivated.,12,0,male_masculine,12,4680
694,970712,common_voice_en_34049077.mp3,Albuquerque was from Goa.,16,4,male_masculine,12,3204
695,725569,common_voice_en_48533.mp3,"You don't have to be rich, skinny, popular, or even own a cape to perform a random act of kindness.",12,0,male_masculine,12,7224
696,546605,common_voice_en_37838722.mp3,The Santa Matilde has a fiberglass body reinforced with polyester.,12,0,male_masculine,12,7236
697,546604,common_voice_en_37838716.mp3,These were all listed in the Table of Contents on the front cover.,12,0,male_masculine,12,5220
698,647875,common_voice_en_39589780.mp3,"He may have been the Venetian sculptor, Alevisio Lamberti da Montagne.",12,0,male_masculine,12,5436
699,843975,common_voice_en_12031.mp3,"That's the man who knows all the secrets of the world, she said.",12,0,male_masculine,12,6024
700,768831,common_voice_en_38383316.mp3,The episode introduces the Gorn.,12,0,male_masculine,12,3528
701,546600,common_voice_en_37838712.mp3,"Famously, Goldmark taught a fifteen-year-old Aaron Copland and the young George Gershwin.",12,0,male_masculine,12,8064
702,546597,common_voice_en_37838704.mp3,The Ritchie campaign retaliates with its own behind-the-scenes political maneuver.,12,0,male_masculine,12,6660
703,491875,common_voice_en_36708.mp3,"As I watched, the planet seemed to grow larger and smaller.",12,0,male_masculine,12,4416
704,546596,common_voice_en_37838703.mp3,It is the tallest free-standing tubular steel structure in the world.,12,0,male_masculine,12,5940
705,546595,common_voice_en_37838696.mp3,Flambeau has since been permanently closed and the site reclaimed.,12,0,male_masculine,12,6372
706,546611,common_voice_en_37838736.mp3,"The World Association of Newspapers lists three earlier, extant titles.",12,0,male_masculine,12,7812
707,1180217,common_voice_en_24405.mp3,Even me — I haven't thought of other women since I met the merchant's daughter.,12,0,male_masculine,12,6624
708,801204,common_voice_en_17240.mp3,I thought the unscrewing might be automatic.,12,0,male_masculine,12,3336
709,1180226,common_voice_en_24414.mp3,You were seen at the enemy camp three days ago.,12,0,male_masculine,12,3552
710,1180228,common_voice_en_24416.mp3,"It would have been visible to me, had I only looked up as it passed.",12,0,male_masculine,12,4224
711,451584,common_voice_en_17047.mp3,"You'll watch them as they grow, demonstrating how the world is always changing.",12,0,male_masculine,12,4536
712,1180250,common_voice_en_24438.mp3,"worked hard just to have food and water, like the sheep.",13,1,male_masculine,12,3720
713,301103,common_voice_en_9796.mp3,I wished I had a light to smoke by.,13,1,male_masculine,12,3288
714,789747,common_voice_en_32335447.mp3,She is also the second ordained woman to hold this position.,12,0,male_masculine,12,7416
715,508898,common_voice_en_9543.mp3,Most of them were staring quietly at the big table.,13,1,male_masculine,12,3672
716,301102,common_voice_en_9795.mp3,It was such a gradual movement that he found it only by noticing the dots.,16,4,male_masculine,12,4440
717,1180251,common_voice_en_24439.mp3,"The Tradition teaches men how to cross the desert, and how their children should marry.",12,0,male_masculine,12,5904
718,594898,common_voice_en_41657.mp3,The turf and gravel around it seemed charred as if by a sudden explosion.,13,1,male_masculine,12,7584
719,628195,common_voice_en_11846.mp3,Maybe because that wasn't really his dream.,13,1,male_masculine,12,3888
720,290750,common_voice_en_38240686.mp3,The boat returned to Faslane naval base on the surface under her own power.,12,0,male_masculine,12,5760
721,594902,common_voice_en_41661.mp3,A line of flame high can be seen in the atmosphere.,12,0,male_masculine,12,5544
722,664495,common_voice_en_39477486.mp3,Compare this with gaff fishing.,12,0,male_masculine,12,3636
723,598443,common_voice_en_38084704.mp3,Richard Hall Pleasants and Elizabeth Moale (Poultney) Pleasants were his parents.,12,0,male_masculine,12,7344
724,628166,common_voice_en_11817.mp3,Does a man's heart always help him? the boy asked the alchemist.,13,1,male_masculine,12,5112
725,1706034,common_voice_en_38251757.mp3,"They were used in operations in the Western Desert, in Iraq, and in Syria.",12,0,male_masculine,12,8388
726,181732,common_voice_en_39582338.mp3,He was the foreign exchange student in a group of six local teenagers.,12,0,male_masculine,12,4464
727,301238,common_voice_en_1221.mp3,But maybe people who felt that way had never learned the universal language.,14,2,male_masculine,12,6312
728,779992,common_voice_en_73987.mp3,Then the thing came upon him in a flash.,12,0,male_masculine,12,3120
729,598306,common_voice_en_32642543.mp3,Coleman also translated various French works for American publishers.,12,0,male_masculine,12,4860
730,628179,common_voice_en_11830.mp3,"There is only one way to learn, the alchemist answered.",13,1,male_masculine,12,4728
731,1058153,common_voice_en_121093.mp3,A line of flame high can be seen in the atmosphere.,14,2,male_masculine,12,4824
732,955669,common_voice_en_30174847.mp3,Kerala Congress (Socialist) soon got dissolved when it merged with the Janata Dal (Secular).,12,0,male_masculine,12,8424
733,594884,common_voice_en_41643.mp3,"Some went away while I was there, and other people came.",12,0,male_masculine,12,5136
734,859103,common_voice_en_16264.mp3,"Down below in the darkness were hundreds of people, sleeping in peace.",12,0,male_masculine,12,4728
735,1145754,common_voice_en_30645572.mp3,This manual is now used all over the world.,18,6,male_masculine,12,3456
736,530500,common_voice_en_7879.mp3,"They blow across the world without a birthplace, and with no place to die.",13,1,male_masculine,12,5520
737,530502,common_voice_en_7881.mp3,"But, just before lunchtime, a boy stopped in front of the shop.",12,0,male_masculine,12,4776
738,859064,common_voice_en_16225.mp3,"And at that I told him, and he took my place.",13,1,male_masculine,12,3600
739,1415855,common_voice_en_37289689.mp3,It was the first public secondary school in South Australia.,12,0,male_masculine,12,3996
740,859051,common_voice_en_16212.mp3,I think they perceived that nothing was to be done at the moment.,13,1,male_masculine,12,3912
741,172862,common_voice_en_7994.mp3,He disappeared into the tent.,13,1,male_masculine,12,4752
742,780533,common_voice_en_9102.mp3,"Looking through the telescope, I saw a circle of deep blue and the little round planet.",13,1,male_masculine,12,6264
743,1044798,common_voice_en_19048.mp3,"You must not let up, even after having come so far, he continued.",12,0,male_masculine,12,5736
744,1831299,common_voice_en_37203107.mp3,"At Kate's Bridge, the road crossed the River Glen.",12,0,male_masculine,12,4536
745,1145674,common_voice_en_30645477.mp3,Waddy had four other siblings.,12,0,male_masculine,12,2988
746,546594,common_voice_en_37838695.mp3,The car was not badged with these additional appellations.,12,0,male_masculine,12,5040
747,1415900,common_voice_en_37289774.mp3,It is located in a plain southwest of Brescia.,12,0,male_masculine,12,4140
748,1832461,common_voice_en_37906268.mp3,One possible explanation for this disappearance is that the whales were overexploited.,12,0,male_masculine,12,8100
749,1044785,common_voice_en_19035.mp3,"I'm going to guide you across the desert, the alchemist said.",12,0,male_masculine,12,4224
750,228866,common_voice_en_20285768.mp3,"The team was managed by owner Carl W. Thompson, Senior before folding.",12,0,male_masculine,12,5544
751,819825,common_voice_en_32914570.mp3,Ensure you have set follow tags option to true,12,0,male_masculine,12,4824
752,633709,common_voice_en_30419227.mp3,It is the highest point in the area.,12,0,male_masculine,12,3996
753,1285440,common_voice_en_31501782.mp3,Refugees and migrants create mobile learning networks with their transnational families and friends.,12,0,male_masculine,12,8280
754,1180068,common_voice_en_24252.mp3,I'm not afraid of failing.,12,0,male_masculine,12,3504
755,776457,common_voice_en_13640.mp3,"I learned how to care for sheep, and I haven't forgotten how that's done.",13,1,male_masculine,12,5136
756,1367814,common_voice_en_32235217.mp3,We have wounded soldiers from both sides.,12,0,male_masculine,12,3276
757,776455,common_voice_en_13638.mp3,"I am here, the boy said.",12,0,male_masculine,12,3576
758,1316502,common_voice_en_20286323.mp3,He served on a government anti-narcotics commission.,12,0,male_masculine,12,5088
759,898257,common_voice_en_37811186.mp3,It came with all the automatic and manual exposure functions but lacked autofocus.,12,0,male_masculine,12,6588
760,700224,common_voice_en_20231.mp3,They're not concerned with that right now.,12,0,male_masculine,12,2184
761,546593,common_voice_en_37838692.mp3,"Luftwaffe aircraft did not often display nose art, but there were exceptions.",12,0,male_masculine,12,6948
762,1367644,common_voice_en_32233593.mp3,She reached the South Pole from her home in Switzerland using only muscle power.,12,0,male_masculine,12,6480
763,546590,common_voice_en_37838677.mp3,"The name ""weaver's knot"" comes from its historic use in textile mills.",12,0,male_masculine,12,7056
764,577333,common_voice_en_42018.mp3,And then he perceived it very slowly.,12,0,male_masculine,12,4368
765,859132,common_voice_en_16293.mp3,"From the railway station in the distance came the sound of trains, ringing and rumbling.",12,0,male_masculine,12,4896
766,859130,common_voice_en_16291.mp3,Everyone seemed very excited.,12,0,male_masculine,12,2712
767,859129,common_voice_en_16290.mp3,The turf and gravel around it seemed charred as if by a sudden explosion.,12,0,male_masculine,12,4512
768,546589,common_voice_en_37838669.mp3,"He was stopped by Colossus, who also wanted to destroy the gem.",12,0,male_masculine,12,5112
769,577328,common_voice_en_42012.mp3,So how will we name all these hurricanes?,12,0,male_masculine,12,4200
770,508871,common_voice_en_9516.mp3,It was dropping off in flakes and raining down on the sand.,12,0,male_masculine,12,4344
771,453436,common_voice_en_10641.mp3,"It was starlight, and I explained the Signs of the Zodiac to her.",13,1,male_masculine,12,4728
772,491868,common_voice_en_36701.mp3,The first rule of don't fight club is let's talk about it.,12,0,male_masculine,12,5256
773,1707528,common_voice_en_38688636.mp3,Leyner also studied with noted post-modern author Steve Katz at the University of Colorado-Boulder.,12,0,male_masculine,12,8928
774,530495,common_voice_en_7874.mp3,The turf and gravel around it seemed charred as if by a sudden explosion.,13,1,male_masculine,12,5952
775,546586,common_voice_en_37838661.mp3,Most had to move on to other areas.,12,0,male_masculine,12,3816
776,546585,common_voice_en_37838657.mp3,"The nafs incorporates all the elements of a person's ""lower self"".",12,0,male_masculine,12,6120
777,491881,common_voice_en_36714.mp3,He approached the mass and was surprised at the size and the shape.,12,0,male_masculine,12,4032
778,453455,common_voice_en_10666.mp3,"At the first glance, it was really not very exciting.",12,0,male_masculine,12,3480
779,859142,common_voice_en_16303.mp3,I got drunk yesterday and thought I built a super computer.,12,0,male_masculine,12,3744
780,516354,common_voice_en_32145206.mp3,No reparations were ever paid to the families of the victims.,15,3,male_masculine,12,5040
781,859140,common_voice_en_16301.mp3,"The level ground was blackened as far as one could see, and it was still giving off smoke.",12,0,male_masculine,12,6048
782,450844,common_voice_en_3407.mp3,"Well, then, why do we need all these books? the boy asked.",12,0,male_masculine,12,4824
783,530473,common_voice_en_7851.mp3,"I can learn something from the desert, too.",13,1,male_masculine,12,5136
784,859133,common_voice_en_16294.mp3,He heard a muffled grating sound and saw the black mark jerk forward an inch or so.,12,0,male_masculine,12,5664
785,722226,common_voice_en_36313103.mp3,Say hi for me.,12,0,male_masculine,12,2448
786,859084,common_voice_en_16245.mp3,"For at that time, it had not occurred to him that it might be hollow.",13,1,male_masculine,12,5736
787,801127,common_voice_en_17162.mp3,"I'm going to find that damned alchemist, the Englishman thought.",12,0,male_masculine,12,4008
788,450852,common_voice_en_3415.mp3,And he knew what was the fair price for every one of his animals.,13,1,male_masculine,12,5664
789,163306,common_voice_en_31496857.mp3,There had already been some teacher training but under her guidance this was expanded.,14,2,male_masculine,12,6336
790,575315,common_voice_en_32687797.mp3,Since the interview no updates were given to the Dutch expansion.,12,0,male_masculine,12,6912
791,760032,common_voice_en_16666.mp3,No one seemed to have thought about it that night.,14,2,male_masculine,12,3048
792,772374,common_voice_en_13347.mp3,Some storms are worth the wreckage.,12,0,male_masculine,12,3192
793,1182392,common_voice_en_30531987.mp3,Each subsequent playoff game has been played at Lambeau Field.,12,0,male_masculine,12,6156
794,573896,common_voice_en_38158916.mp3,She grew up in Sacramento and attended Rio Americano High School.,12,0,male_masculine,12,5796
795,1182167,common_voice_en_30531291.mp3,Each half deck is shuffled and placed on the appropriate space on the board.,12,0,male_masculine,12,5616
796,1182110,common_voice_en_30531134.mp3,Believed to be inspired by the British Cornish pasty or Spanish empanadas and pastel.,12,0,male_masculine,12,7740
797,1182257,common_voice_en_30531470.mp3,Local famers carted stone from the quarry free of charge.,12,0,male_masculine,12,4896
798,772355,common_voice_en_13327.mp3,YOU WANNA TAKE THIS OUTSIDE?,13,1,male_masculine,12,2232
799,1182268,common_voice_en_30531586.mp3,He died in Santa Marta.,12,0,male_masculine,12,3708
800,759987,common_voice_en_16621.mp3,"Before guns were invented, armies had to throw bullets at each other and if a bullet touched you, you had to sit out until the next war.",12,0,male_masculine,12,7920
801,652111,common_voice_en_34831.mp3,"Sometime during the second year, you'll remember about the treasure.",12,0,male_masculine,12,5496
802,1182331,common_voice_en_30531880.mp3,They utilize the native language terms in Swedish and in Finnish.,12,0,male_masculine,12,4896
803,1182349,common_voice_en_30531943.mp3,She received her schooling in Kohima and Shillong.,12,0,male_masculine,12,4716
804,575318,common_voice_en_32687800.mp3,She is married to an Indian.,12,0,male_masculine,12,4248
805,1182284,common_voice_en_30531641.mp3,It is unclear which of the five brothers are the ones responsible.,12,0,male_masculine,12,5436
806,1703749,common_voice_en_31481791.mp3,It was certified gold in its first week.,12,0,male_masculine,12,4320
807,772392,common_voice_en_13365.mp3,A line of flame high can be seen in the atmosphere.,12,0,male_masculine,12,4608
808,760028,common_voice_en_16662.mp3,Can I get a woot woot!?,12,0,male_masculine,12,3360
809,1182295,common_voice_en_30531672.mp3,I will not enlarge on the mournful subject.,12,0,male_masculine,12,6048
810,760027,common_voice_en_16661.mp3,There was very little talking.,12,0,male_masculine,12,2472
811,1345593,common_voice_en_28710028.mp3,Caxton reminds him that he is no longer a part of Jessie's life.,15,3,male_masculine,12,5004
812,760026,common_voice_en_16660.mp3,Strange images passed through my mind.,12,0,male_masculine,12,3912
813,1182380,common_voice_en_30531975.mp3,This (third) series had two volumes.,12,0,male_masculine,12,3888
814,1182144,common_voice_en_30531192.mp3,The series is directed by Mainak Bhaumik.,12,0,male_masculine,12,4896
815,1182142,common_voice_en_30531190.mp3,It includes land in both Pima County and Santa Cruz County.,12,0,male_masculine,12,5220
816,1182139,common_voice_en_30531182.mp3,The river was known for its salmon and trout fishing in the Victoria era.,12,0,male_masculine,12,6228
817,1182137,common_voice_en_30531180.mp3,Freedman lives with his family in the Los Angeles Metropolitan Area.,12,0,male_masculine,12,5616
818,759968,common_voice_en_16602.mp3,Ogilvy watched till one and then gave up.,13,1,male_masculine,12,3456
819,760016,common_voice_en_16650.mp3,It was faintly marked with transverse stripes and slightly flattened from the perfect round.,12,0,male_masculine,12,5832
820,495346,common_voice_en_53191.mp3,"Revenge is not my style, but obviously accidents will happen.",12,0,male_masculine,12,4344
821,742468,common_voice_en_30702881.mp3,Elder brother Paul is the Minister of Education.,12,0,male_masculine,12,4176
822,829765,common_voice_en_37109924.mp3,The studio was fitted with all-new digital equipment.,12,0,male_masculine,12,5076
823,760011,common_voice_en_16645.mp3,"From the railway station in the distance came the sound of trains, ringing and rumbling.",12,0,male_masculine,12,5304
824,377339,common_voice_en_35672.mp3,The people were also praying to heaven for protection.,12,0,male_masculine,12,4296
825,697321,common_voice_en_17781477.mp3,"Is it possible, if you would be so kind, to lend me your brolly for today?",12,0,male_masculine,12,5184
826,1588235,common_voice_en_18251603.mp3,The lazy cow lay in the cool grass.,12,0,male_masculine,12,4824
827,575295,common_voice_en_32686667.mp3,It gained all of Moore County.,12,0,male_masculine,12,4536
828,1825610,common_voice_en_32357382.mp3,From the early twentieth century they played early music.,12,0,male_masculine,12,4860
829,759982,common_voice_en_16616.mp3,Henderson stood up with a spade in his hand.,13,1,male_masculine,12,4128
830,772382,common_voice_en_13355.mp3,Now I will drift gently off to dreamland.,12,0,male_masculine,12,3912
831,423295,common_voice_en_36952.mp3,'m all about those invisible cosmic connections that transcend time and distance.,12,0,male_masculine,12,5568
832,759972,common_voice_en_16606.mp3,We lit the lantern and walked over to his house.,13,1,male_masculine,12,3888
833,1162046,common_voice_en_37141314.mp3,He has played international matches for Moldova.,12,0,male_masculine,12,3780
834,760002,common_voice_en_16636.mp3,"You should see the other guy, specifically, how good at fighting he is.",12,0,male_masculine,12,5304
835,772395,common_voice_en_13368.mp3,"It was seen early in the morning, rushing over eastward.",12,0,male_masculine,12,4296
836,859155,common_voice_en_16316.mp3,I thought the unscrewing might be automatic.,11,0,male_masculine,11,3624
837,628155,common_voice_en_11806.mp3,It was the first time she had done that.,12,1,male_masculine,11,3336
838,385771,common_voice_en_24534.mp3,"Had our instruments permitted it, we might have been able to see the trouble way back when.",11,0,male_masculine,11,5136
839,801210,common_voice_en_17246.mp3,The alchemist knocked on the gate of the monastery.,11,0,male_masculine,11,3696
840,768280,common_voice_en_20992.mp3,Butmaybe I'll never have another chance to get to the Pyramids in Egypt.,11,0,male_masculine,11,4560
841,381744,common_voice_en_12240.mp3,They shouted consolation and promises and went off back to the town again to get help.,11,0,male_masculine,11,5976
842,172903,common_voice_en_11188.mp3,Henderson was taking it in.,11,0,male_masculine,11,3096
843,801217,common_voice_en_17253.mp3,All the joy he had seen that morning had suddenly disappeared.,11,0,male_masculine,11,5184
844,697611,common_voice_en_23536.mp3,I'm never more aware of a room's acoustics than when I'm trying to enjoy a snack I have no intention of sharing.,12,1,male_masculine,11,6864
845,451587,common_voice_en_17050.mp3,The invaders carried the name everywhere. The beautiful girl spoke of the invaders with pride.,11,0,male_masculine,11,5568
846,772393,common_voice_en_13366.mp3,Most of them were staring quietly at the big table.,11,0,male_masculine,11,3576
847,399038,common_voice_en_75336.mp3,Some of those who saw its flight say it travelled with a hissing sound.,11,0,male_masculine,11,4536
848,381748,common_voice_en_12244.mp3,They formed heaps that are visible a mile and a half away.,13,2,male_masculine,11,4296
849,843958,common_voice_en_12014.mp3,But they really don't know what they're saying.,11,0,male_masculine,11,4056
850,301106,common_voice_en_9799.mp3,"It was seen early in the morning, rushing over eastward.",11,0,male_masculine,11,5088
851,303133,common_voice_en_32973.mp3,It was such a gradual movement that he found it only by noticing the dots.,11,0,male_masculine,11,5400
852,859060,common_voice_en_16221.mp3,I SHALL MAKE US SOME ICE CUBES.,11,0,male_masculine,11,2688
853,1180137,common_voice_en_24321.mp3,The merchant was silent for a few moments.,12,1,male_masculine,11,3264
854,423300,common_voice_en_36957.mp3,Most meteorites are more or less rounded.,12,1,male_masculine,11,3792
855,859158,common_voice_en_16319.mp3,No one seemed to have thought about it that night.,11,0,male_masculine,11,3048
856,491883,common_voice_en_36716.mp3,It was only when I got this close to it that the strangeness of it was at all evident to me.,12,1,male_masculine,11,6144
857,628172,common_voice_en_11823.mp3,"The sheep will get used to my not being there, too, the boy thought.",14,3,male_masculine,11,5112
858,1180190,common_voice_en_24378.mp3,Did you see the garden that it took the master gardener ten years to create?,11,0,male_masculine,11,5184
859,1179973,common_voice_en_24156.mp3,I'm interested only in the present.,11,0,male_masculine,11,2904
860,759956,common_voice_en_16590.mp3,I think they perceived that nothing was to be done at the moment.,13,2,male_masculine,11,6048
861,569737,common_voice_en_18069228.mp3,You have a couch?,11,0,male_masculine,11,2544
862,859054,common_voice_en_16215.mp3,"Of course, the two were unable to do anything.",11,0,male_masculine,11,2952
863,859053,common_voice_en_16214.mp3,It was dropping off in flakes and raining down on the sand.,11,0,male_masculine,11,4128
864,1044827,common_voice_en_19077.mp3,Because you are trying to realize your destiny.,11,0,male_masculine,11,3456
865,859074,common_voice_en_16235.mp3,A boy came running towards me.,13,2,male_masculine,11,2376
866,197486,common_voice_en_17325.mp3,The conversation was interrupted by the warehouse boss.,11,0,male_masculine,11,4536
867,303203,common_voice_en_18089716.mp3,"I could be wrong, but it's somewhere in that region.",11,0,male_masculine,11,2976
868,381750,common_voice_en_12247.mp3,"My seven year resume gap is marked ""Not Drugs"".",12,1,male_masculine,11,4464
869,577327,common_voice_en_42011.mp3,You point to a trail of ants leading into the house.,11,0,male_masculine,11,4416
870,859076,common_voice_en_16237.mp3,Then the thing came upon him in a flash.,13,2,male_masculine,11,3024
871,759962,common_voice_en_16596.mp3,Dense clouds of smoke or dust can be seen through a powerful telescope.,11,0,male_masculine,11,4848
872,1157961,common_voice_en_44924.mp3,It's extremely suspicious that there's no information about brains that didn't come from a brain.,11,0,male_masculine,11,4464
873,843961,common_voice_en_12017.mp3,"Some went away while I was there, and other people came.",11,0,male_masculine,11,4608
874,453209,common_voice_en_45279.mp3,"In those days, very few of the people had any idea about astronomy.",11,0,male_masculine,11,5424
875,700187,common_voice_en_20194.mp3,I'm already used to the way things are.,11,0,male_masculine,11,2232
876,323510,common_voice_en_8597.mp3,"Everything in life is an omen, said the Englishman, now closing the journal he was reading.",11,0,male_masculine,11,6264
877,355680,common_voice_en_18044.mp3,Some of those who saw its flight say it travelled with a hissing sound.,12,1,male_masculine,11,4704
878,504321,common_voice_en_18289568.mp3,The wagon moved on well oiled wheels.,12,1,male_masculine,11,3744
879,354040,common_voice_en_35285.mp3,YOU WANNA TAKE THIS OUTSIDE?,12,1,male_masculine,11,2544
880,776438,common_voice_en_13621.mp3,I've already told you.,11,0,male_masculine,11,2736
881,201654,common_voice_en_20900.mp3,It brought his heart into his mouth.,11,0,male_masculine,11,3456
882,450857,common_voice_en_3420.mp3,But he knew that Salem wasn't in Andalusia.,11,0,male_masculine,11,5328
883,776460,common_voice_en_13643.mp3,It was my fear of failure that first kept me from attempting the Master Work.,13,2,male_masculine,11,20184
884,1180157,common_voice_en_24343.mp3,But arms cannot be drawn unless they also go into battle.,11,0,male_masculine,11,3696
885,503394,common_voice_en_12985.mp3,"Suddenly, one of the hawks made a flashing dive through the sky, attacking the other.",11,0,male_masculine,11,4992
886,508891,common_voice_en_9536.mp3,That's why I'm here in the middle of het desert.,11,0,male_masculine,11,4656
887,776419,common_voice_en_13602.mp3,I have already described the appearance of that colossal bulk which was embedded in the ground.,11,0,male_masculine,11,8664
888,776449,common_voice_en_13632.mp3,"Once to the thief, and once to the general.",11,0,male_masculine,11,4224
889,503406,common_voice_en_12997.mp3,"And I'd better read your books, said the boy.",11,0,male_masculine,11,3072
890,272865,common_voice_en_15937.mp3,A large piece suddenly came off and fell with a loud and sharp noise.,11,0,male_masculine,11,5040
891,272868,common_voice_en_15940.mp3,Some of the grey ash was falling off the circular edge.,11,0,male_masculine,11,3360
892,503417,common_voice_en_13008.mp3,"And maybe it wasn't that they were teaching me, but that I was learning from them.",11,0,male_masculine,11,4560
893,486193,common_voice_en_20284747.mp3,It does not take account of time dilation.,11,0,male_masculine,11,4728
894,699774,common_voice_en_18364337.mp3,We will be meeting Abhishek there later tonight.,11,0,male_masculine,11,4104
895,167810,common_voice_en_10061.mp3,It may be the gases of the firing that caused the Martians inconvenience.,12,1,male_masculine,11,6192
896,776400,common_voice_en_13583.mp3,The boy brought his horse closer.,11,0,male_masculine,11,3624
897,1044725,common_voice_en_18974.mp3,"I don't much like change, he said.",11,0,male_masculine,11,3096
898,776395,common_voice_en_13578.mp3,"From atop its walls, one can catch a glimpse of Africa.",11,0,male_masculine,11,5976
899,503396,common_voice_en_12987.mp3,"But then they wouldn't be a part of your future, the seer had said.",11,0,male_masculine,11,4152
900,508896,common_voice_en_9541.mp3,"It's a code, said the boy, a bit disappointed.",11,0,male_masculine,11,4152
901,508895,common_voice_en_9540.mp3,"I don't understand what you're talking about, the desert said.",11,0,male_masculine,11,4944
902,301236,common_voice_en_1219.mp3,"They're not my sheep anymore, he said to himself, without nostalgia.",11,0,male_masculine,11,7248
903,801189,common_voice_en_17225.mp3,"And you ought to read more about the world, answered the Englishman.",11,0,male_masculine,11,4536
904,381756,common_voice_en_12256.mp3,Most meteorites are more or less rounded.,12,1,male_masculine,11,3696
905,492687,common_voice_en_46137.mp3,Hires two personal trainers and make one of them train the other one.,11,0,male_masculine,11,4392
906,508882,common_voice_en_9527.mp3,"Well, then, why do we need all these books? the boy asked.",12,1,male_masculine,11,4920
907,801208,common_voice_en_17244.mp3,"He took Urim and Thummim from his pocket, and began playing with them.",11,0,male_masculine,11,5328
908,1044806,common_voice_en_19056.mp3,"And maybe it wasn't that they were teaching me, but that I was learning from them.",11,0,male_masculine,11,5184
909,508872,common_voice_en_9517.mp3,He had helped him out in a dangerous situation.,13,2,male_masculine,11,4296
910,801142,common_voice_en_17177.mp3,"Before the boy could reply, a butterfly appeared and fluttered between him and the old man.",11,0,male_masculine,11,7224
911,760029,common_voice_en_16663.mp3,I thought the unscrewing might be automatic.,11,0,male_masculine,11,3384
912,417875,common_voice_en_20286132.mp3,"The group was originally co-founded by American neo-Nazi, J. T. Ready.",11,0,male_masculine,11,5592
913,228863,common_voice_en_20285764.mp3,This has caused some confusion.,11,0,male_masculine,11,4224
914,355682,common_voice_en_18046.mp3,"There were really, I think, two or three hundred people elbowing one another.",11,0,male_masculine,11,5472
915,760037,common_voice_en_16671.mp3,Hundreds of observers saw the flame that night and the night after.,11,0,male_masculine,11,5232
916,776468,common_voice_en_13652.mp3,The boy was startled.,11,0,male_masculine,11,2184
917,1044619,common_voice_en_18865.mp3,"I don't know how to find life in the desert, the boy said.",11,0,male_masculine,11,3864
918,963531,common_voice_en_21722.mp3,The Englishman's eyes lit up.,11,0,male_masculine,11,2736
919,843981,common_voice_en_12037.mp3,But he still couldn't flee.,11,0,male_masculine,11,3576
920,355689,common_voice_en_18053.mp3,The crowd swayed a little as I elbowed my way through.,11,0,male_masculine,11,4056
921,1180128,common_voice_en_24312.mp3,"The closer he got to the realization of his dream, the more difficult things became.",12,1,male_masculine,11,4944
922,1025401,common_voice_en_20280034.mp3,He assisted wide receivers coach David Culley in coaching his unit.,11,0,male_masculine,11,7320
923,700206,common_voice_en_20213.mp3,"The following night, the boy appeared at the alchemist's tent with a horse.",11,0,male_masculine,11,4272
924,700205,common_voice_en_20212.mp3,"I know good crystal from bad, and everything else there is to know about crystal.",11,0,male_masculine,11,4368
925,760035,common_voice_en_16669.mp3,I was impatient to see it opened.,11,0,male_masculine,11,2808
926,1022485,common_voice_en_74491.mp3,"There, the alchemist separated the disk into four parts.",11,0,male_masculine,11,3864
927,599032,common_voice_en_87537.mp3,They formed heaps that are visible a mile and a half away.,11,0,male_masculine,11,4104
928,768291,common_voice_en_21003.mp3,"And you've told me nothing along the way, said the boy.",11,0,male_masculine,11,3912
929,453434,common_voice_en_10639.mp3,I'm never more aware of a room's acoustics than when I'm trying to enjoy a snack I have no intention of sharing.,14,3,male_masculine,11,6624
930,1180292,common_voice_en_24480.mp3,"Sometimes, their caravan met with another.",11,0,male_masculine,11,3576
931,1180083,common_voice_en_24267.mp3,"You are almost at the end of your journey, said the alchemist.",11,0,male_masculine,11,4272
932,548306,common_voice_en_20629.mp3,He recited an Our Father silently.,11,0,male_masculine,11,3960
933,859123,common_voice_en_16284.mp3,It seemed so safe and tranquil.,12,1,male_masculine,11,2856
934,725538,common_voice_en_48501.mp3,My tax dollars pay for those public school proms.,11,0,male_masculine,11,3936
935,759976,common_voice_en_16610.mp3,All that time the Martians must have been getting ready.,12,1,male_masculine,11,3864
936,1278434,common_voice_en_20285790.mp3,This pairing did not last long.,12,1,male_masculine,11,4656
937,723443,common_voice_en_82869.mp3,"You should see the other guy, specifically, how good at fighting he is.",11,0,male_masculine,11,6120
938,1180039,common_voice_en_24223.mp3,Because you will never again be able to keep it quiet.,11,0,male_masculine,11,3840
939,759997,common_voice_en_16631.mp3,Some storms are worth the wreckage.,11,0,male_masculine,11,3408
940,548309,common_voice_en_20633.mp3,"I'm leaving today, said the boy.",11,0,male_masculine,11,3024
941,780556,common_voice_en_9125.mp3,have trusted more in your love for Fatima.,16,5,male_masculine,11,3336
942,530501,common_voice_en_7880.mp3,came to the bar he had entered on his first day there.,11,0,male_masculine,11,4584
943,1180270,common_voice_en_24458.mp3,"But there's a tribal war, the boy reiterated.",11,0,male_masculine,11,3384
944,172904,common_voice_en_11189.mp3,"Among these people were a couple of cyclists, a gardener I employed sometimes, and a girl carrying a baby.",12,1,male_masculine,11,7704
945,453456,common_voice_en_10667.mp3,"The level ground was blackened as far as one could see, and it was still giving off smoke.",17,6,male_masculine,11,5304
946,760005,common_voice_en_16639.mp3,I heard a peculiar humming sound from the pit.,11,0,male_masculine,11,3816
947,780588,common_voice_en_9158.mp3,It's not a battle of good against evil.,15,4,male_masculine,11,2904
948,1278420,common_voice_en_20285570.mp3,"His great-grandparents were from Huesca, in the Aragon region.",12,1,male_masculine,11,5856
949,548296,common_voice_en_20619.mp3,"It means only that the heart does what it can, the alchemist said.",11,0,male_masculine,11,5040
950,759978,common_voice_en_16612.mp3,Some of the grey ash was falling off the circular edge.,11,0,male_masculine,11,4176
951,772341,common_voice_en_13313.mp3,This morning I found a calculator taped to my Wii.,11,0,male_masculine,11,3624
952,780558,common_voice_en_9127.mp3,"It's not what enters men's mouths that's evil, said the alchemist.",15,4,male_masculine,11,5184
953,772340,common_voice_en_13312.mp3,This was the strangest of all things that ever came to earth from outer space.,11,0,male_masculine,11,6624
954,452115,common_voice_en_91132.mp3,The night was warm and I was thirsty.,11,0,male_masculine,11,5184
955,780591,common_voice_en_9161.mp3,Even then he hardly understood what this meant.,11,0,male_masculine,11,3336
956,780565,common_voice_en_9134.mp3,He had always believed that the sheep were able to understand what he said.,16,5,male_masculine,11,4824
957,772339,common_voice_en_13311.mp3,There were lights in the upper windows of the houses when the people went to bed.,12,1,male_masculine,11,4896
958,859100,common_voice_en_16261.mp3,"Before guns were invented, armies had to throw bullets at each other and if a bullet touched you, you had to sit out until the next war.",12,1,male_masculine,11,8304
959,859068,common_voice_en_16229.mp3,A large piece suddenly came off and fell with a loud and sharp noise.,11,0,male_masculine,11,5184
960,723401,common_voice_en_82826.mp3,"And at that I told him, and he took my place.",11,0,male_masculine,11,4080
961,530496,common_voice_en_7875.mp3,The infidels had an evil look about them.,11,0,male_masculine,11,4080
962,780544,common_voice_en_9113.mp3,No one said a word as the old man continued.,12,1,male_masculine,11,3936
963,772348,common_voice_en_13320.mp3,"The heather was on fire, and you could see a thin blue smoke rising up slowly.",12,1,male_masculine,11,5952
964,859125,common_voice_en_16286.mp3,I myself heard nothing of that.,11,0,male_masculine,11,2424
965,1762216,common_voice_en_31851846.mp3,He also serves as deputy head of the United Front Work Department.,11,0,male_masculine,11,6192
966,859138,common_voice_en_16299.mp3,It was faintly marked with transverse stripes and slightly flattened from the perfect round.,11,0,male_masculine,11,5304
967,453454,common_voice_en_10665.mp3,Then came the night of the first falling star.,12,1,male_masculine,11,3096
968,1180074,common_voice_en_24258.mp3,Then it became a signal of danger.,11,0,male_masculine,11,2424
969,1426285,common_voice_en_22114288.mp3,one,11,0,male_masculine,11,2832
970,772415,common_voice_en_13388.mp3,"It was as if it quivered, but really this was the telescope vibrating.",12,1,male_masculine,11,5856
971,530486,common_voice_en_7865.mp3,The stranger seemed satisfied with the answer.,12,1,male_masculine,11,6504
972,725575,common_voice_en_48539.mp3,It seemed to him that it fell to earth about one hundred miles east of here.,12,1,male_masculine,11,5304
973,859119,common_voice_en_16280.mp3,Something inside the cylinder was unscrewing the top.,12,1,male_masculine,11,3336
974,329752,common_voice_en_3506.mp3,"I came to tell you just one thing, the boy said.",11,0,male_masculine,11,5208
975,423296,common_voice_en_36953.mp3,"That night, there was another jetting out of gas from the distant planet.",12,1,male_masculine,11,4944
976,28236,common_voice_en_9444.mp3,"But, finally, he agreed that the boy, who spoke better Arabic than he, should do so.",15,4,male_masculine,11,5736
977,548314,common_voice_en_20638.mp3,"All I saw was an army, said the boy.",11,0,male_masculine,11,3624
978,780552,common_voice_en_9121.mp3,The man wept with happiness.,13,2,male_masculine,11,3144
979,780524,common_voice_en_9092.mp3,"He did find it, soon after dawn, and not far from the sand pits.",13,2,male_masculine,11,5256
980,725577,common_voice_en_48541.mp3,"Besides that, there was a heap of bicycles.",11,0,male_masculine,11,3744
981,548315,common_voice_en_20639.mp3,"I'm an alchemist simply because I'm an alchemist, he said, as he prepared the meal.",11,0,male_masculine,11,6600
982,780523,common_voice_en_9091.mp3,Imagine if everyone went around transforming lead into gold.,12,1,male_masculine,11,4296
983,727106,common_voice_en_21912593.mp3,four,10,0,male_masculine,10,2496
984,727053,common_voice_en_19277736.mp3,He also directed three films.,10,0,male_masculine,10,3792
985,849507,common_voice_en_31067109.mp3,Her research considers epigenetic processes including genomic imprinting.,10,0,male_masculine,10,5796
986,784856,common_voice_en_32372088.mp3,He then scaled the ladder to retrieve the briefcase.,10,0,male_masculine,10,4176
987,727093,common_voice_en_20520836.mp3,"They said, 'We won't give you the degree if you don't wear this.",10,0,male_masculine,10,5448
988,727092,common_voice_en_20520835.mp3,‘Come — are you coming?’ I continued.,10,0,male_masculine,10,4032
989,776464,common_voice_en_13648.mp3,"You must not let up, even after having come so far, he continued.",10,0,male_masculine,10,7704
990,727089,common_voice_en_20317685.mp3,This usually also applies to foreign students.,10,0,male_masculine,10,4416
991,849506,common_voice_en_31067108.mp3,Brian Ramer was the team captain.,10,0,male_masculine,10,3708
992,727054,common_voice_en_19277737.mp3,Its territory was part of the present-day German lands Lower Saxony and North Rhine-Westphalia.,10,0,male_masculine,10,7680
993,849490,common_voice_en_31067035.mp3,Henry Jennings and Leigh Ashworth became privateers based in Jamaica.,10,0,male_masculine,10,5688
994,1180044,common_voice_en_24228.mp3,I have the diet of a kid who found twenty dollars.,11,1,male_masculine,10,3840
995,849505,common_voice_en_31067107.mp3,"Her work was published in ""Ebony"" and ""Jet"".",10,0,male_masculine,10,4068
996,849501,common_voice_en_31067078.mp3,She studied at the Bauhaus and her designs are still being produced.,10,0,male_masculine,10,5400
997,784861,common_voice_en_32372104.mp3,Suki finds James and rescues him.,10,0,male_masculine,10,5040
998,727088,common_voice_en_20317684.mp3,They are very critical and careful about mythological sources.,10,0,male_masculine,10,5760
999,859117,common_voice_en_16278.mp3,"Yet, it was a little too large for assurance.",10,0,male_masculine,10,3720
1000,727087,common_voice_en_20317682.mp3,"Various larger animals nest in them, including the northern flying squirrel.",10,0,male_masculine,10,7224
1001,849504,common_voice_en_31067106.mp3,Finding methods of transportation can become expensive and often discouraging for elders.,10,0,male_masculine,10,6696
1002,784823,common_voice_en_32371940.mp3,It was created in association with and featuring the music of Peter Gabriel.,10,0,male_masculine,10,6660
1003,849502,common_voice_en_31067079.mp3,Bold teams are still in competition.,10,0,male_masculine,10,3600
1004,784860,common_voice_en_32372102.mp3,Shah is also the guide for postgraduate students in Obs.,10,0,male_masculine,10,6912
1005,776436,common_voice_en_13619.mp3,"I can interpret it, but the interpretation is very difficult.",10,0,male_masculine,10,6024
1006,849499,common_voice_en_31067064.mp3,Appearances and goals by national team and year,10,0,male_masculine,10,4320
1007,849498,common_voice_en_31067063.mp3,It ensures the protection of the characteristic landscape of the Southern Laurentians.,10,0,male_masculine,10,6336
1008,776482,common_voice_en_13666.mp3,The invaders carried the name everywhere. The beautiful girl spoke of the invaders with pride.,10,0,male_masculine,10,7224
1009,727066,common_voice_en_19545414.mp3,All of the drivers involved took the restart; some in spare cars.,10,0,male_masculine,10,7080
1010,849500,common_voice_en_31067077.mp3,The new body was elected by open list proportional representation.,10,0,male_masculine,10,4896
1011,1062141,common_voice_en_32731144.mp3,He was subsequently relieved and returned to the United States.,10,0,male_masculine,10,5904
1012,849497,common_voice_en_31067062.mp3,After an accident he lost most of his vision.,10,0,male_masculine,10,3636
1013,727065,common_voice_en_19545412.mp3,"She was originally nicknamed ""Rosita"".",10,0,male_masculine,10,4464
1014,727064,common_voice_en_19545411.mp3,All lines are powered by electric overhead lines.,10,0,male_masculine,10,4680
1015,727067,common_voice_en_19580154.mp3,"Soon after, they found Tommy Shaw.",10,0,male_masculine,10,4152
1016,577337,common_voice_en_42022.mp3,'m all about those invisible cosmic connections that transcend time and distance.,10,0,male_masculine,10,7248
1017,449352,common_voice_en_35130867.mp3,The Irish element of Puerto Rico is very much in evidence.,10,0,male_masculine,10,5040
1018,1821405,common_voice_en_30347248.mp3,Little else is recorded of his early life.,12,2,male_masculine,10,5940
1019,727068,common_voice_en_19580155.mp3,Denise and Lawrence arrive at the red star and quickly find the dragons.,10,0,male_masculine,10,8664
1020,1180078,common_voice_en_24262.mp3,"I'm looking for a treasure, said the boy, and he immediately regretted having said it.",10,0,male_masculine,10,5400
1021,784827,common_voice_en_32371963.mp3,The collection was reprinted in February of the same year.,10,0,male_masculine,10,5040
1022,652097,common_voice_en_34815.mp3,Other servants maintained the fires in the hookahs.,10,0,male_masculine,10,4416
1023,776458,common_voice_en_13641.mp3,Absolutely despicable that gingerbread men are forced to live in houses made of their own flesh.,10,0,male_masculine,10,8496
1024,727104,common_voice_en_21912591.mp3,Firefox,15,5,male_masculine,10,2616
1025,776440,common_voice_en_13623.mp3,He couldn't have been wrong.,10,0,male_masculine,10,2856
1026,449353,common_voice_en_35130895.mp3,Central City joined the league during the season.,10,0,male_masculine,10,3600
1027,1819284,common_voice_en_27959965.mp3,Its teams are nicknamed the Golden Bulls.,10,0,male_masculine,10,5076
1028,849491,common_voice_en_31067036.mp3,There have been cases where discarded syringes were found with liquid inside.,10,0,male_masculine,10,5616
1029,849526,common_voice_en_31067190.mp3,She was considered an expert on the biosynthesis of polyamines.,10,0,male_masculine,10,5508
1030,565203,common_voice_en_37060970.mp3,"His third large film was ""The Others"", a ghost story starring Nicole Kidman.",12,2,male_masculine,10,6912
1031,449351,common_voice_en_35130866.mp3,He criticized with virulence his foreign policy.,10,0,male_masculine,10,4320
1032,776454,common_voice_en_13637.mp3,"If he abandons that pursuit, it's because it wasn't truelove...",10,0,male_masculine,10,5856
1033,727103,common_voice_en_21912590.mp3,seven,10,0,male_masculine,10,2376
1034,859122,common_voice_en_16283.mp3,"I had the ""everyone has Gary Busey's teeth"" dream again.",10,0,male_masculine,10,4176
1035,727069,common_voice_en_19580156.mp3,"These soils consist of moderately deep, well drained soils on uplands.",10,0,male_masculine,10,6648
1036,727063,common_voice_en_19545410.mp3,"He was raised in New Orleans, Louisiana.",10,0,male_masculine,10,4728
1037,849525,common_voice_en_31067188.mp3,He studied hairdressing and was trained in the profession.,10,0,male_masculine,10,4248
1038,849492,common_voice_en_31067037.mp3,The only live specimens were collected from shrubs and tree trunks.,10,0,male_masculine,10,5220
1039,849472,common_voice_en_31066910.mp3,Troubles for the Royal Park were more than financial.,10,0,male_masculine,10,4428
1040,849473,common_voice_en_31066912.mp3,Baseball Hall of Fame member Jake Beckley played for the Soldiers.,10,0,male_masculine,10,5616
1041,679149,common_voice_en_78953.mp3,The top had certainly ceased to rotate.,10,0,male_masculine,10,2952
1042,449345,common_voice_en_35130809.mp3,Fecundation is another term for fertilization.,10,0,male_masculine,10,5256
1043,1093743,common_voice_en_38739448.mp3,Most Outstanding Candidate in the Caribbean- Nicholas Sammy.,10,0,male_masculine,10,6012
1044,354037,common_voice_en_35282.mp3,"He did find it, soon after dawn, and not far from the sand pits.",11,1,male_masculine,10,5328
1045,361595,common_voice_en_12329.mp3,"I'm a desert woman, and I'm proud of that.",11,1,male_masculine,10,3984
1046,1093741,common_voice_en_38739445.mp3,"The use of neural implants has recently been attempted, with success, on cockroaches.",10,0,male_masculine,10,7272
1047,1093740,common_voice_en_38739438.mp3,Herlovsen was usually used in the central defence or as a defensive midfielder.,10,0,male_masculine,10,6660
1048,727107,common_voice_en_21912599.mp3,Hey,10,0,male_masculine,10,2640
1049,1825159,common_voice_en_32246121.mp3,The firm was able to offer high colour printing.,10,0,male_masculine,10,3816
1050,1767754,common_voice_en_18031397.mp3,Samantha's boots felt heavy and her chest was tightening.,10,0,male_masculine,10,4080
1051,849474,common_voice_en_31066913.mp3,Blair was married twice.,10,0,male_masculine,10,3096
1052,849475,common_voice_en_31066914.mp3,Kozlov is the nearest rural locality.,10,0,male_masculine,10,3888
1053,1705250,common_voice_en_37807566.mp3,"From the launch date, however, the service was quickly losing money.",12,2,male_masculine,10,7020
1054,784857,common_voice_en_32372089.mp3,He joined the newly formed Indonesian Army following the Bandung Sea of Fire incident.,10,0,male_masculine,10,7308
1055,1398812,common_voice_en_58798.mp3,"I want to see him do it, said the chief.",10,0,male_masculine,10,2736
1056,784882,common_voice_en_32372160.mp3,Unpredictable events happen every now and then here.,10,0,male_masculine,10,5544
1057,849476,common_voice_en_31066955.mp3,She also write articles in several international and national newspapers.,10,0,male_masculine,10,5796
1058,849509,common_voice_en_31067121.mp3,Then onwards he was known by that name.,10,0,male_masculine,10,3960
1059,1093738,common_voice_en_38739433.mp3,This has created an emphasis upon a light and mobile land contingent.,10,0,male_masculine,10,5652
1060,849494,common_voice_en_31067039.mp3,The troupe had also toured to about nine countries and recorded stage performances.,10,0,male_masculine,10,6120
1061,849495,common_voice_en_31067060.mp3,Brown was Presbyterian.,10,0,male_masculine,10,3240
1062,784830,common_voice_en_32371966.mp3,He was an Executive Vice President of the company.,10,0,male_masculine,10,5220
1063,1093756,common_voice_en_38739538.mp3,They eventually began speaking Spanish and inter-marrying with other tribes.,10,0,male_masculine,10,6084
1064,204959,common_voice_en_11865.mp3,But the merchant understood what the boy had said.,10,0,male_masculine,10,3096
1065,849465,common_voice_en_31066854.mp3,He previously played for the Sam Houston State Bearkats.,10,0,male_masculine,10,5076
1066,429148,common_voice_en_66425.mp3,He just got a new kite for his birthday.,10,0,male_masculine,10,3504
1067,849466,common_voice_en_31066855.mp3,The use of the soil near the river is mainly forest and agricultural.,10,0,male_masculine,10,5940
1068,450841,common_voice_en_3404.mp3,But those who know about such things would know that those are Urim and Thummim.,11,1,male_masculine,10,7368
1069,849471,common_voice_en_31066908.mp3,The club colors are green and black.,10,0,male_masculine,10,3168
1070,849468,common_voice_en_31066887.mp3,"Mickey received full rotation on radio for songs ""Get Out"" and ""All That Acid"".",10,0,male_masculine,10,6336
1071,849493,common_voice_en_31067038.mp3,She performed at various theaters after that.,10,0,male_masculine,10,4248
1072,449349,common_voice_en_35130864.mp3,"‘Nothing like it,’ replied his father.",10,0,male_masculine,10,3456
1073,1706083,common_voice_en_38254747.mp3,He wore a necklace of fruit or fishbones strung on a cotton thread.,10,0,male_masculine,10,7416
1074,1093716,common_voice_en_38739346.mp3,"Its capital is the city of Dangriga, formerly known as Stann Creek Town.",10,0,male_masculine,10,6948
1075,849469,common_voice_en_31066888.mp3,He has published many religious works.,10,0,male_masculine,10,3456
1076,1093715,common_voice_en_38739344.mp3,"In more recent times, Frank Gehry designed the Frederick R. Weisman Art Museum.",10,0,male_masculine,10,6660
1077,449347,common_voice_en_35130812.mp3,His mother is Ukrainian.,10,0,male_masculine,10,3060
1078,449346,common_voice_en_35130810.mp3,"A graph with degeneracy ""p"" is called ""p""-degenerate.",10,0,male_masculine,10,5436
1079,776402,common_voice_en_13585.mp3,I can only tell you what I saw.,10,0,male_masculine,10,3144
1080,431922,common_voice_en_38530849.mp3,Biometric telemetry failed sometime after the fourth orbit.,10,0,male_masculine,10,5796
1081,1706364,common_voice_en_38300145.mp3,How are we to exactly divide the two persons of the divinity.,10,0,male_masculine,10,7848
1082,784879,common_voice_en_32372157.mp3,The Lithuanian government evacuated from Vilnius to Kaunas.,10,0,male_masculine,10,6768
1083,727071,common_voice_en_19580158.mp3,"This article is incomplete, editors are welcome to contribute to expanding this list.",10,0,male_masculine,10,8424
1084,1093722,common_voice_en_38739364.mp3,John Armstrong Senior was a renowned Pennsylvania soldier born in Ireland of Scottish descent.,10,0,male_masculine,10,8532
1085,727072,common_voice_en_19580164.mp3,A second time he was refused.,10,0,male_masculine,10,3792
1086,849486,common_voice_en_31067010.mp3,The boundaries of the province are obscure.,10,0,male_masculine,10,4320
1087,1075935,common_voice_en_31466195.mp3,Workers were often moved to temporarily live in work stations outside their cities.,10,0,male_masculine,10,7128
1088,727073,common_voice_en_19580165.mp3,"Furthermore, he benefited from the conflict in the right-wing majority.",10,0,male_masculine,10,6816
1089,849488,common_voice_en_31067013.mp3,The entire expressway lies within Yokohama in Kanagawa Prefecture,10,0,male_masculine,10,5940
1090,849510,common_voice_en_31067122.mp3,It flowers August through October.,10,0,male_masculine,10,3816
1091,1180062,common_voice_en_24246.mp3,The old woman had said the same thing.,10,0,male_masculine,10,2952
1092,727076,common_voice_en_19580168.mp3,Various air taxi companies are based at the airport.,10,0,male_masculine,10,5928
1093,449365,common_voice_en_35149989.mp3,It was their last winter together.,10,0,male_masculine,10,3636
1094,727047,common_voice_en_19275389.mp3,All of these were awarded for rescue operations.,10,0,male_masculine,10,5328
1095,727048,common_voice_en_19275390.mp3,His deputy is Helga Krismer from the Greens.,10,0,male_masculine,10,4752
1096,727049,common_voice_en_19275391.mp3,The institute has done pioneering work in low cost housing and city planning.,10,0,male_masculine,10,7368
1097,727050,common_voice_en_19277733.mp3,"This work has been translated into Spanish, German, Hebrew, and Japanese.",10,0,male_masculine,10,7584
1098,727051,common_voice_en_19277734.mp3,He helped develop a number of prospecting and exploration technologies.,10,0,male_masculine,10,5352
1099,776425,common_voice_en_13608.mp3,"When the pan had cooled, the monk and the boy looked at it, dazzled.",10,0,male_masculine,10,5904
1100,849489,common_voice_en_31067014.mp3,We spent maybe two or three hours on it.,10,0,male_masculine,10,3636
1101,727074,common_voice_en_19580166.mp3,The town of South River sits on western side near its mouth.,10,0,male_masculine,10,7128
1102,849511,common_voice_en_31067123.mp3,Gabe allows Tanya to escape rather than shooting her.,10,0,male_masculine,10,4788
1103,849480,common_voice_en_31066959.mp3,It also features Moritaka playing the accordion solo.,10,0,male_masculine,10,4968
1104,784881,common_voice_en_32372159.mp3,The book has had positive ratings at Goodreads.,10,0,male_masculine,10,5364
1105,849482,common_voice_en_31066981.mp3,The conflict was sharp and there was considerable loss of life.,10,0,male_masculine,10,5256
1106,727055,common_voice_en_19277738.mp3,It is noted that it is exclusive to those four stations.,10,0,male_masculine,10,5736
1107,727056,common_voice_en_19277739.mp3,Gilbert became pregnant months later.,10,0,male_masculine,10,3960
1108,776432,common_voice_en_13615.mp3,Fill this place with a sandstorm so strong that it blots out the sun.,10,0,male_masculine,10,7416
1109,922419,common_voice_en_38353443.mp3,Alvey is currently a board advisor and Chief Scientist of Ceros.,10,0,male_masculine,10,6084
1110,727057,common_voice_en_19277740.mp3,Chipp was married twice.,10,0,male_masculine,10,3144
1111,1093725,common_voice_en_38739380.mp3,Pasion had two sons with his wife Archippe: Apollodorus and Pasikles.,10,0,male_masculine,10,6732
1112,784880,common_voice_en_32372158.mp3,Initially she sailed between London and Quebec.,10,0,male_masculine,10,5580
1113,849483,common_voice_en_31066982.mp3,He played as forward.,10,0,male_masculine,10,2916
1114,727058,common_voice_en_19277741.mp3,Many of the more minor lights are not shown.,10,0,male_masculine,10,4320
1115,1362985,common_voice_en_35209886.mp3,He performed widely in the West End and at the National Theatre.,10,0,male_masculine,10,5148
1116,1093728,common_voice_en_38739389.mp3,Many Alabama singles and albums represented crossover appeal on the pop charts.,10,0,male_masculine,10,6804
1117,727060,common_voice_en_19279279.mp3,Li began studying piano at the age of seven.,10,0,male_masculine,10,4944
1118,1093726,common_voice_en_38739382.mp3,"The community has the name of James Cushing, a pioneer citizen.",10,0,male_masculine,10,5364
1119,849484,common_voice_en_31066983.mp3,This led to the Nacionalistas losing their majority in the House of Representatives.,10,0,male_masculine,10,6048
1120,727061,common_voice_en_19279280.mp3,The song describes intense boredom.,10,0,male_masculine,10,4704
1121,776443,common_voice_en_13626.mp3,They called that discovery the Master Work — it was part liquid and part solid.,11,1,male_masculine,10,9216
1122,776434,common_voice_en_13617.mp3,"From that day on, it was the desert that would be important.",10,0,male_masculine,10,5016
1123,1044791,common_voice_en_19041.mp3,The boy looked around him at the date palms.,10,0,male_masculine,10,3336
1124,727099,common_voice_en_20566335.mp3,"Its claims have been rejected, however, by mainstream science and academia.",10,0,male_masculine,10,7080
1125,727100,common_voice_en_20566336.mp3,One year his television program won an award.,10,0,male_masculine,10,5352
1126,330663,common_voice_en_18364077.mp3,"I do not like sushi, so I did not really enjoy the meal.",10,0,male_masculine,10,5136
1127,727101,common_voice_en_20566337.mp3,She was the middle child.,10,0,male_masculine,10,3840
1128,784839,common_voice_en_32372061.mp3,Its capital is decorated with sculpted snakes and other reptiles.,10,0,male_masculine,10,6372
1129,784874,common_voice_en_32372136.mp3,"Both remixes were later released on the reissue deluxe release of ""Meet the Woo"".",10,0,male_masculine,10,7884
1130,768301,common_voice_en_21013.mp3,But bakers are more important people than shepherds.,10,0,male_masculine,10,3384
1131,530499,common_voice_en_7878.mp3,"It's a code, said the boy, a bit disappointed.",10,0,male_masculine,10,5208
1132,849514,common_voice_en_31067147.mp3,Otherwise the braincase is similar between the two taxa.,10,0,male_masculine,10,5040
1133,449359,common_voice_en_35149902.mp3,He was dismissed for a pair of ducks in his debut Test at Headingley.,10,0,male_masculine,10,5220
1134,727102,common_voice_en_21912589.mp3,one,10,0,male_masculine,10,2472
1135,241541,common_voice_en_18370422.mp3,William Shakespeare was an English poet and playwright that lived during the late sixteenth century.,10,0,male_masculine,10,7368
1136,727110,common_voice_en_21912602.mp3,three,10,0,male_masculine,10,2400
1137,784810,common_voice_en_32371869.mp3,She joined Solihull Horticultural Society and started to organise their flower shows.,10,0,male_masculine,10,7092
1138,727111,common_voice_en_21912603.mp3,zero,10,0,male_masculine,10,2856
1139,449360,common_voice_en_35149953.mp3,You get knocked down and you pick up yourself and you move on.,10,0,male_masculine,10,4068
1140,303129,common_voice_en_32969.mp3,I'm never more aware of a room's acoustics than when I'm trying to enjoy a snack I have no intention of sharing.,10,0,male_masculine,10,6264
1141,1072471,common_voice_en_30626719.mp3,This marine species occurs off the Philippines.,10,0,male_masculine,10,5004
1142,617656,common_voice_en_636987.mp3,"It was glaringly hot, not a cloud in the sky nor a breath of wind.",10,0,male_masculine,10,5184
1143,784803,common_voice_en_32371748.mp3,"It is similar to the smaller ""Acer rubrum"".",10,0,male_masculine,10,5796
1144,727119,common_voice_en_25978606.mp3,I don't think anyone disagrees.,10,0,male_masculine,10,3276
1145,491867,common_voice_en_36700.mp3,"About eleven, I walked back to my home in Maybury because nothing seemed to be happening.",10,0,male_masculine,10,5376
1146,784837,common_voice_en_32372059.mp3,Her father was Edgar Marsh Crookshank known for his work on vaccination.,10,0,male_masculine,10,7020
1147,651282,common_voice_en_68605.mp3,"It would have been visible to me, had I only looked up as it passed.",10,0,male_masculine,10,4824
1148,784838,common_voice_en_32372060.mp3,The tourists will begin witness greenery from the entrance gate itself.,10,0,male_masculine,10,7128
1149,784804,common_voice_en_32371750.mp3,Kenny Gamble and Kyle Warwick were the team captains.,10,0,male_masculine,10,6228
1150,1316497,common_voice_en_20286308.mp3,"While playing for Poland, he helped them win several titles.",10,0,male_masculine,10,5184
1151,784876,common_voice_en_32372150.mp3,Each round ends with the team voting off one person from the game.,10,0,male_masculine,10,7164
1152,784809,common_voice_en_32371868.mp3,She has cited Missy Elliott as an influence.,10,0,male_masculine,10,5328
1153,784821,common_voice_en_32371927.mp3,The shire office was in Wagga Wagga.,10,0,male_masculine,10,4140
1154,784875,common_voice_en_32372147.mp3,Two men were subsequently tried for his murder and executed.,10,0,male_masculine,10,6120
1155,1398009,common_voice_en_57976.mp3,Several figures approached him.,10,0,male_masculine,10,1944
1156,37796,common_voice_en_18689.mp3,My mind ran on the possibilities of its content.,11,1,male_masculine,10,4032
1157,727094,common_voice_en_20520837.mp3,He was for the most part self-educated.,10,0,male_masculine,10,4632
1158,727095,common_voice_en_20520838.mp3,It was hinted that he was a ghost.,10,0,male_masculine,10,4248
1159,727096,common_voice_en_20520839.mp3,This version was also cut.,10,0,male_masculine,10,3744
1160,727097,common_voice_en_20566333.mp3,It has been claimed that it is the smallest river in Europe.,10,0,male_masculine,10,6648
1161,727098,common_voice_en_20566334.mp3,The local economy is heavily reliant on agriculture and supporting services.,10,0,male_masculine,10,8040
1162,449358,common_voice_en_35149901.mp3,She was acquitted in the court.,10,0,male_masculine,10,3096
1163,727116,common_voice_en_21912618.mp3,The call would then be transferred manually.,10,0,male_masculine,10,5184
1164,1179989,common_voice_en_24172.mp3,"I'm a woman of the desert, she said, averting her face.",10,0,male_masculine,10,4728
1165,727117,common_voice_en_25978602.mp3,She never reads.,10,0,male_masculine,10,2664
1166,859156,common_voice_en_16317.mp3,He had seen the shooting star and was persuaded that a meteorite lay somewhere nearby.,10,0,male_masculine,10,5592
1167,747245,common_voice_en_32644726.mp3,Eban has written two books.,10,0,male_masculine,10,3168
1168,1180002,common_voice_en_24185.mp3,"Tomorrow, at this same time, bring me a tenth of your flock.",11,1,male_masculine,10,4416
1169,784873,common_voice_en_32372135.mp3,What is Benchmarking?,10,0,male_masculine,10,3708
1170,784872,common_voice_en_32372134.mp3,She is the first woman to hold the office.,10,0,male_masculine,10,3960
1171,859154,common_voice_en_16315.mp3,An huge hole had been made by the impact of the projectile.,10,0,male_masculine,10,4680
1172,1833810,common_voice_en_39254056.mp3,The latter is known as Haverhill fever.,10,0,male_masculine,10,4716
1173,859153,common_voice_en_16314.mp3,But that was simply because my eye was tired.,10,0,male_masculine,10,3624
1174,1072365,common_voice_en_30626522.mp3,These were collected from different villages.,10,0,male_masculine,10,3312
1175,784813,common_voice_en_32371872.mp3,The building is designed in Italian Renaissance Revival style.,10,0,male_masculine,10,5832
1176,449363,common_voice_en_35149957.mp3,And then he looked straight down between his feet.,10,0,male_masculine,10,3888
1177,859091,common_voice_en_16252.mp3,YOU WANNA TAKE THIS OUTSIDE?,12,2,male_masculine,10,1920
1178,859151,common_voice_en_16312.mp3,The top of the cylinder was rotating on its body.,10,0,male_masculine,10,3528
1179,784812,common_voice_en_32371871.mp3,Sand martins nest on the old quarry face.,10,0,male_masculine,10,4932
1180,449362,common_voice_en_35149955.mp3,"Falk, playing Pino, has never been better in a movie.",10,0,male_masculine,10,4608
1181,329742,common_voice_en_3496.mp3,He had come to the town only to find a woman who could interpret his dream.,10,0,male_masculine,10,5832
1182,449364,common_voice_en_35149988.mp3,It is now deployed with South Korean Air Force and the Philippine Air Force.,10,0,male_masculine,10,6228
1183,727112,common_voice_en_21912614.mp3,six,10,0,male_masculine,10,2280
1184,617647,common_voice_en_636977.mp3,It spread through the planet's atmosphere and obscured its more familiar features.,10,0,male_masculine,10,7584
1185,292279,common_voice_en_551821.mp3,I have already described the appearance of that colossal bulk which was embedded in the ground.,10,0,male_masculine,10,8712
1186,859116,common_voice_en_16277.mp3,Some storms are worth the wreckage.,10,0,male_masculine,10,2496
1187,1044816,common_voice_en_19066.mp3,"He didn't know the man yet, but his practiced eye would recognize him when he appeared.",11,1,male_masculine,10,5184
1188,1398877,common_voice_en_58863.mp3,"They went in to drink the tea, which was served in beautiful crystal glasses.",10,0,male_masculine,10,4896
1189,784819,common_voice_en_32371925.mp3,It possess central nervous system stimulant activity and produces bradycardia and hypotension in cats.,10,0,male_masculine,10,9396
1190,784811,common_voice_en_32371870.mp3,The leaf margin is entire or lightly toothed and the tip acute or acuminate.,10,0,male_masculine,10,7056
1191,727113,common_voice_en_21912615.mp3,five,10,0,male_masculine,10,2760
1192,727115,common_voice_en_21912617.mp3,two,10,0,male_masculine,10,2304
1193,859073,common_voice_en_16234.mp3,I have the diet of a kid who found twenty dollars.,12,2,male_masculine,10,3864
1194,1316493,common_voice_en_20286273.mp3,"The Fantasy Game is discussed in greater depth in ""Ender's Shadow"".",10,0,male_masculine,10,7824
1195,1157953,common_voice_en_44916.mp3,Ogilvy told him everything that he had seen.,11,1,male_masculine,10,2304
1196,784814,common_voice_en_32371884.mp3,The department is headed by Jerry Stokes.,10,0,male_masculine,10,3924
1197,859065,common_voice_en_16226.mp3,"I was scared, but wasted no time in going out and crossing the bridge to the sand pits.",10,0,male_masculine,10,5664
1198,1829269,common_voice_en_36495588.mp3,"This promise, so far as I know, he did not live to fulfill.",10,0,male_masculine,10,5796
1199,1701998,common_voice_en_30401531.mp3,It is used in Vietnamese traditional medicine.,10,0,male_masculine,10,5076
1200,784822,common_voice_en_32371939.mp3,The bombing was successful in destroying much of the arsenal.,10,0,male_masculine,10,5184
1201,727114,common_voice_en_21912616.mp3,nine,10,0,male_masculine,10,2208
1202,784816,common_voice_en_32371886.mp3,"he was born of the Virgin Mary, and became man.",10,0,male_masculine,10,4788
1203,530488,common_voice_en_7867.mp3,"Bakers have homes, while shepherds sleep out in the open.",11,1,male_masculine,10,5760
1204,530490,common_voice_en_7869.mp3,"When he was a child, that man wanted to travel, too.",10,0,male_masculine,10,4848
1205,849520,common_voice_en_31067172.mp3,White flowers are often seen in the winter months.,10,0,male_masculine,10,4356
1206,849521,common_voice_en_31067173.mp3,Schumer also serves as an executive producer.,10,0,male_masculine,10,4140
1207,849523,common_voice_en_31067185.mp3,Long time staff include Marilyn Good and Paul Bauer.,10,0,male_masculine,10,5040
1208,849524,common_voice_en_31067186.mp3,Her letters in these journals were among their most charming features.,10,0,male_masculine,10,5040
1209,727080,common_voice_en_19784446.mp3,This foundation assists communities in various ways.,10,0,male_masculine,10,5568
1210,849528,common_voice_en_31067225.mp3,The two watch the fireworks for Princess Carolyn and Judah.,10,0,male_masculine,10,4860
1211,849529,common_voice_en_31067226.mp3,Another crucial research area of Stebbins is serious leisure perspective.,10,0,male_masculine,10,5868
1212,1044784,common_voice_en_19034.mp3,"When I'm eating, that's all I think about.",10,0,male_masculine,10,3384
1213,849530,common_voice_en_31067228.mp3,There she landed her cargo and she was surveyed.,10,0,male_masculine,10,4140
1214,849531,common_voice_en_31067229.mp3,She is only known under her family name Fang.,10,0,male_masculine,10,4140
1215,849532,common_voice_en_31067249.mp3,"Before he left he set fire to ""Greenwich"".",10,0,male_masculine,10,3996
1216,710166,common_voice_en_30681168.mp3,The genus name honors paleontologist George Gaylord Simpson.,10,0,male_masculine,10,6228
1217,317712,common_voice_en_40085163.mp3,A balance between particle capture and flow requirements must be met while ensuring integrity.,10,0,male_masculine,10,6480
1218,849534,common_voice_en_31067251.mp3,It is narrow anteriorly and wider posteriorly.,10,0,male_masculine,10,4788
1219,849535,common_voice_en_31067252.mp3,He founded the Kleist Music School in Frankfurt (Oder).,10,0,male_masculine,10,5076
1220,548327,common_voice_en_20652.mp3,I have been waiting for you here at this oasis for a long time.,10,0,male_masculine,10,4536
1221,1705325,common_voice_en_37990981.mp3,"Life'll Kill Ya and ""Don't Let Us Get Sick"" also have prominent death themes.",10,0,male_masculine,10,9216
1222,784864,common_voice_en_32372111.mp3,He has an expertise in planning law and environmental law.,10,0,male_masculine,10,5292
1223,679199,common_voice_en_79003.mp3,'m all about those invisible cosmic connections that transcend time and distance.,10,0,male_masculine,10,5832
1224,1767314,common_voice_en_18016106.mp3,My paycheck isn't coming until next week.,10,0,male_masculine,10,2712
1225,784825,common_voice_en_32371942.mp3,Her parents were Robert Dunn Gilson and Lydia Gilson.,10,0,male_masculine,10,5904
1226,849508,common_voice_en_31067120.mp3,He was interred at the Western Road Cemetery in George Town.,10,0,male_masculine,10,5328
1227,784828,common_voice_en_32371964.mp3,The trees are set in fine lawns naturally inhibited by the dense tree canopy.,10,0,male_masculine,10,6804
1228,1316501,common_voice_en_20286312.mp3,The neat bonding between the outer and inner rings gives it another unique feature.,10,0,male_masculine,10,7272
1229,784829,common_voice_en_32371965.mp3,It was briefly seized by Taiping troops but recovered.,10,0,male_masculine,10,5616
1230,776470,common_voice_en_13654.mp3,"Well, he thought about that, the old man said.",10,0,male_masculine,10,4344
1231,727078,common_voice_en_19784444.mp3,Bob Marley was a noted member.,10,0,male_masculine,10,3528
1232,849519,common_voice_en_31067171.mp3,Different etymological dictionaries give different meanings for the word stack.,10,0,male_masculine,10,5688
1233,849543,common_voice_en_31067308.mp3,A dedicated Google Assistant button is located between the power and shutter buttons.,10,0,male_masculine,10,5796
1234,849513,common_voice_en_31067145.mp3,They were led by head coach Tad Boyle in his eleventh season at Colorado.,10,0,male_masculine,10,6300
1235,1044794,common_voice_en_19044.mp3,The boy began to dig into the dune.,10,0,male_masculine,10,2904
1236,727079,common_voice_en_19784445.mp3,She grew sick at the sound.,10,0,male_masculine,10,3912
1237,849515,common_voice_en_31067148.mp3,Speculation about his successor started quickly afterwards.,10,0,male_masculine,10,5076
1238,849516,common_voice_en_31067149.mp3,Coleman was married to David Coleman and had four children.,10,0,male_masculine,10,4716
1239,929820,common_voice_en_37863138.mp3,The Association's President is Sheikh Salman Bin Ibrahim Al-Khalifa.,10,0,male_masculine,10,7308
1240,849517,common_voice_en_31067169.mp3,It is constructed of stone masonry.,10,0,male_masculine,10,3636
1241,1704829,common_voice_en_37266443.mp3,"Daniel was the author of a number of works, condemning heretics in Russia.",10,0,male_masculine,10,6480
1242,849542,common_voice_en_31067306.mp3,Many species rely on tidal marshes which would be threatened as marshes erode.,10,0,male_masculine,10,6408
1243,727085,common_voice_en_20293187.mp3,Dogs and cats show few if any signs of infection.,10,0,male_masculine,10,6624
1244,784877,common_voice_en_32372152.mp3,She reached Plymouth and London without incident.,10,0,male_masculine,10,5184
1245,486202,common_voice_en_20285215.mp3,His most significant success was in the large number of heavy-duty trucks he manufactured.,10,0,male_masculine,10,6336
1246,784820,common_voice_en_32371926.mp3,This really make the story work while using real meat.,10,0,male_masculine,10,5868
1247,727086,common_voice_en_20293188.mp3,The Atlantic City Line is a commuter train and runs daily all day.,10,0,male_masculine,10,6816
1248,317723,common_voice_en_40086848.mp3,City University is headquartered in the Belltown area of downtown Seattle.,10,0,male_masculine,10,4932
1249,449357,common_voice_en_35149899.mp3,"Some may undergo further specialized training, such as in cardiology or oncology.",10,0,male_masculine,10,8100
1250,727118,common_voice_en_25978603.mp3,The laying is of two white eggs without any marks.,10,0,male_masculine,10,5256
1251,1310025,common_voice_en_36872023.mp3,Then air would be pumped in from air compressors at the surface.,10,0,male_masculine,10,5148
1252,849536,common_voice_en_31067253.mp3,It may be of hybrid origin.,10,0,male_masculine,10,3060
1253,1429812,common_voice_en_38033425.mp3,"Under this brand, beverages are dispensed from machines, but not in the canned format.",12,2,male_masculine,10,8568
1254,172861,common_voice_en_7993.mp3,"It seemed as if what the old king had called ""beginner's luck"" were no longer functioning.",10,0,male_masculine,10,6456
1255,911689,common_voice_en_31834375.mp3,She entered the tournament as the third seed.,10,0,male_masculine,10,4644
1256,1157873,common_voice_en_44832.mp3,They shouted consolation and promises and went off back to the town again to get help.,11,1,male_masculine,10,3864
1257,381746,common_voice_en_12242.mp3,Its lower end was still embedded.,11,1,male_masculine,10,2736
1258,491865,common_voice_en_36698.mp3,"They looked for the fallen mass, but found nothing.",10,0,male_masculine,10,2952
1259,1022646,common_voice_en_74652.mp3,I know its dimensions and how it behaves.,10,0,male_masculine,10,3384
1260,1121515,common_voice_en_36937712.mp3,The task devolves on the unmarried girl who is next of kin to him.,10,0,male_masculine,10,6768
1261,784802,common_voice_en_32371747.mp3,There are also altars for Shennong and Guan Yu.,10,0,male_masculine,10,6336
1262,486205,common_voice_en_20285272.mp3,The following year he was appointed Knight Bachelor.,10,0,male_masculine,10,4608
1263,849537,common_voice_en_31067274.mp3,On offer were small cars that were specially designed for the physically handicapped.,10,0,male_masculine,10,5616
1264,956948,common_voice_en_37531241.mp3,In later life he fell into great poverty.,10,0,male_masculine,10,4392
1265,859128,common_voice_en_16289.mp3,A thin circle of bright metal showed between the top and the body of the cylinder.,10,0,male_masculine,10,5376
1266,172859,common_voice_en_7991.mp3,"And I'm certain you'll find it, the alchemist said.",12,2,male_masculine,10,5592
1267,849539,common_voice_en_31067276.mp3,It was shot at the Franklin Institute in Philadelphia.,10,0,male_masculine,10,4536
1268,849540,common_voice_en_31067287.mp3,Clayden practiced in Johannesburg until the Second World War.,10,0,male_masculine,10,4968
1269,768309,common_voice_en_21021.mp3,"And, tomorrow, his enemy would also be a part of that Soul.",10,0,male_masculine,10,4560
1270,849544,common_voice_en_31067310.mp3,Most regular season road games will be streamed.,10,0,male_masculine,10,4356
1271,859112,common_voice_en_16273.mp3,It's extremely suspicious that there's no information about brains that didn't come from a brain.,10,0,male_masculine,10,6000
1272,1157857,common_voice_en_44816.mp3,It had a diameter of about thirty yards.,11,1,male_masculine,10,2736
1273,849545,common_voice_en_31067312.mp3,The action feels like baseball.,10,0,male_masculine,10,2916
1274,453459,common_voice_en_10671.mp3,It looked like a rusty gas float.,10,0,male_masculine,10,3000
1275,784865,common_voice_en_32372117.mp3,The records and standings of this league are unknown.,10,0,male_masculine,10,4932
1276,784866,common_voice_en_32372118.mp3,An awareness campaign was launched and citizens were advised to stay home.,10,0,male_masculine,10,6336
1277,1044772,common_voice_en_19022.mp3,"I want to tell you a story about dreams, said the alchemist.",10,0,male_masculine,10,4416
1278,727083,common_voice_en_20293185.mp3,He took written notes.,10,0,male_masculine,10,3000
1279,849546,common_voice_en_31067320.mp3,This identity was further aided by his strong delivery and trademark handlebar moustache.,10,0,male_masculine,10,7020
1280,849548,common_voice_en_31067327.mp3,"but at one point everyone looks around and says, why are we running?",10,0,male_masculine,10,5328
1281,727084,common_voice_en_20293186.mp3,Dozens of demo crews formed within a year to try and do just that.,10,0,male_masculine,10,8064
1282,859106,common_voice_en_16267.mp3,Replace the Ts in Tim Tebow's name with any other consonant to get a Star Wars character,10,0,male_masculine,10,6216
1283,628162,common_voice_en_11813.mp3,"He wanted your money, he said.",11,1,male_masculine,10,3240
1284,1093909,common_voice_en_38743201.mp3,In the final she placed second.,10,0,male_masculine,10,3816
1285,639079,common_voice_en_22117757.mp3,six,10,0,male_masculine,10,2064
1286,1093907,common_voice_en_38742838.mp3,"Best known for their three-speeds, they were an economy line for Raleigh.",10,0,male_masculine,10,5616
1287,1093906,common_voice_en_38742835.mp3,She wears a long petticoat reaching below her knees.,10,0,male_masculine,10,5040
1288,285135,common_voice_en_18259391.mp3,The prolific developer contributed more than a thousand commits until today.,10,0,male_masculine,10,6168
1289,664508,common_voice_en_39477630.mp3,"He collected them in annual cycles; five are mentioned in obituaries, three are extant.",10,0,male_masculine,10,8064
1290,1093936,common_voice_en_38743375.mp3,It is unique because of its leaflike sheaths of the ramicauls.,10,0,male_masculine,10,5400
1291,1093934,common_voice_en_38743369.mp3,"At the time, it was known as among Japanese.",10,0,male_masculine,10,4644
1292,801162,common_voice_en_17198.mp3,"Eventually, the merchant had to hire two more employees.",10,0,male_masculine,10,4104
1293,664488,common_voice_en_39476676.mp3,The Board unanimously approved the resolution.,10,0,male_masculine,10,4140
1294,1093928,common_voice_en_38743343.mp3,He is writing about electronic publishing.,10,0,male_masculine,10,4608
1295,1093894,common_voice_en_38742774.mp3,Many other nations that desired tanks could not design or build their own.,10,0,male_masculine,10,5724
1296,784847,common_voice_en_32372079.mp3,He would be able to send her good intelligence on French initiatives in Scotland.,10,0,male_masculine,10,6552
1297,1093892,common_voice_en_38742758.mp3,They sometimes masqueraded as civilians and wore civilian clothes.,10,0,male_masculine,10,5256
1298,1093891,common_voice_en_38742757.mp3,He has also represented the Uruguay national team.,10,0,male_masculine,10,4464
1299,352687,common_voice_en_1331.mp3,He was more certain of it than of anything in the world.,13,3,male_masculine,10,6696
1300,1831615,common_voice_en_37343577.mp3,This may lead to teams assigned to a division other than their geographical one.,10,0,male_masculine,10,7128
1301,628158,common_voice_en_11809.mp3,Then the thing came upon him in a flash.,10,0,male_masculine,10,4152
1302,1701193,common_voice_en_28682248.mp3,The Fourth of July celebration is the biggest week in Hill City.,10,0,male_masculine,10,5616
1303,456727,common_voice_en_31594.mp3,He heard a muffled grating sound and saw the black mark jerk forward an inch or so.,10,0,male_masculine,10,6000
1304,784842,common_voice_en_32372064.mp3,It was referred to the Senate Assignments Committee.,10,0,male_masculine,10,3996
1305,945063,common_voice_en_37988996.mp3,"It was invented by Chris Spurrell, a research chemist from Hawthorne, California.",10,0,male_masculine,10,6156
1306,451575,common_voice_en_17038.mp3,"Night fell, and an assortment of fighting men and merchants entered and exited the tent.",10,0,male_masculine,10,5208
1307,859160,common_voice_en_16321.mp3,"In spite of this, I still believed that there were men in Mars.",10,0,male_masculine,10,4488
1308,1093941,common_voice_en_38743399.mp3,His talents were soon noticed.,10,0,male_masculine,10,4284
1309,759986,common_voice_en_16620.mp3,"There were raised voices,and some sort of struggle appeared to be going on. .",10,0,male_masculine,10,5304
1310,1243715,common_voice_en_17972401.mp3,Do not cross the yellow line.,12,2,male_masculine,10,1488
1311,1180303,common_voice_en_24492.mp3,"If we serve tea in crystal, the shop is going to expand.",10,0,male_masculine,10,4464
1312,1093965,common_voice_en_38745280.mp3,There must be a large quantity of air generated by the exploding mixture.,10,0,male_masculine,10,5148
1313,1093943,common_voice_en_38743403.mp3,"For non-inertial observers, and in general relativity, coordinate systems can be chosen more freely.",10,0,male_masculine,10,7596
1314,784844,common_voice_en_32372066.mp3,The following rounds at Croft and Brands Hatch were then cancelled.,10,0,male_masculine,10,5904
1315,1093961,common_voice_en_38745260.mp3,You would never have guessed he was a president's son.,10,0,male_masculine,10,4176
1316,87407,common_voice_en_32377098.mp3,The soundtrack received positive reviews from critics and music listeners.,10,0,male_masculine,10,7020
1317,1828525,common_voice_en_36311457.mp3,Campgrounds include Rainbow Point and Cherry Creek.,10,0,male_masculine,10,5256
1318,1093925,common_voice_en_38743303.mp3,The township includes the unincorporated communities of Hannahstown and Jefferson Center.,10,0,male_masculine,10,6336
1319,1141603,common_voice_en_36911288.mp3,The pot with the frog is then placed in the hollow wooden cup.,12,2,male_masculine,10,5112
1320,87408,common_voice_en_32377100.mp3,Usually served on halved coconut shells.,10,0,male_masculine,10,5652
1321,150426,common_voice_en_18485968.mp3,"Conversely, a wave whose phase drifts quickly will have a short coherence time.",10,0,male_masculine,10,7608
1322,87409,common_voice_en_32377101.mp3,Fox does not air network programming on weekdays.,10,0,male_masculine,10,5256
1323,1093951,common_voice_en_38743432.mp3,The Carabinieri provide military police services to all the Italian armed force.,10,0,male_masculine,10,6948
1324,451571,common_voice_en_17034.mp3,"You can't be the wind, the wind said.",10,0,male_masculine,10,2688
1325,694137,common_voice_en_30677954.mp3,These achievements have received the warmest recognition far beyond the borders of Germany.,10,0,male_masculine,10,6336
1326,801202,common_voice_en_17238.mp3,"On the seventh day, the alchemist decided to make camp earlier than usual.",10,0,male_masculine,10,5856
1327,1069921,common_voice_en_18060794.mp3,They took the axe and the saw to the forest.,10,0,male_masculine,10,4344
1328,508901,common_voice_en_9546.mp3,"So, he asked if the old man's blessing was still with him.",11,1,male_masculine,10,4080
1329,508899,common_voice_en_9544.mp3,So his heart was quiet for an entire afternoon.,10,0,male_masculine,10,3984
1330,801198,common_voice_en_17234.mp3,The city was still sleeping.,11,1,male_masculine,10,2544
1331,1093860,common_voice_en_38741364.mp3,For many it was an introduction into an alternative lifestyle.,10,0,male_masculine,10,5184
1332,1707248,common_voice_en_38570623.mp3,"Bereuter was born in York, Nebraska and reared in Utica, Nebraska.",10,0,male_masculine,10,6552
1333,1093888,common_voice_en_38741657.mp3,This was accomplished through the instalments of 'spycameras'.,10,0,male_masculine,10,6192
1334,1093920,common_voice_en_38743271.mp3,The fishery industry is synonym with Mukah town too.,10,0,male_masculine,10,5220
1335,1093886,common_voice_en_38741646.mp3,"Following the end of hostilities the squadron was moved to Spitalgate, Lincs.",10,0,male_masculine,10,5796
1336,801185,common_voice_en_17221.mp3,The boy reminded the old man that he had said something about hidden treasure.,10,0,male_masculine,10,6024
1337,508885,common_voice_en_9530.mp3,"At that time, it was quite clear in my own mind that the thing had come from the planet Mars.",10,0,male_masculine,10,6984
1338,861536,common_voice_en_19539.mp3,"You can't be the wind, the wind said.",10,0,male_masculine,10,4656
1339,1707205,common_voice_en_38570177.mp3,Only one card can be moved at a time.,10,0,male_masculine,10,3708
1340,1183314,common_voice_en_25714997.mp3,She is constructed from glass-reinforced plastic.,10,0,male_masculine,10,3564
1341,628149,common_voice_en_11800.mp3,The boy became fearful; the omens told him that something was wrong.,10,0,male_masculine,10,4896
1342,1093881,common_voice_en_38741510.mp3,The central lower lobe is long and the side lobes are about long.,10,0,male_masculine,10,5040
1343,801170,common_voice_en_17206.mp3,"They didn't have the printing press in those days, the boy argued.",10,0,male_masculine,10,4824
1344,942437,common_voice_en_38627504.mp3,Charles Bernstein is married to artist Susan Bee.,10,0,male_masculine,10,4428
1345,801187,common_voice_en_17223.mp3,"Fatima, the girl said, averting her eyes.",10,0,male_masculine,10,4200
1346,1704311,common_voice_en_36826289.mp3,"Flights could also be booked for weekdays, but only by special arrangement.",10,0,male_masculine,10,7452
1347,1093917,common_voice_en_38743257.mp3,Several details of this story are uncertain.,10,0,male_masculine,10,4752
1348,1093915,common_voice_en_38743244.mp3,Her niece Marina Ried also became an actress.,10,0,male_masculine,10,4752
1349,87410,common_voice_en_32377102.mp3,Opposition parties largely criticised that people would be limited on their right to vote.,10,0,male_masculine,10,7308
1350,1093911,common_voice_en_38743226.mp3,Sandbach Rugby Club offers playing opportunities for both sexes of all ages.,10,0,male_masculine,10,6120
1351,1301315,common_voice_en_31148433.mp3,He was the son of William Duns and his wife Sarah Allen.,10,0,male_masculine,10,5868
1352,187048,common_voice_en_37303666.mp3,"In plaintext files, there are two common formats.",10,0,male_masculine,10,6048
1353,72440,common_voice_en_39139821.mp3,"Several programs of study are also accredited, including many of the medically related programs.",10,0,male_masculine,10,9288
1354,72439,common_voice_en_39139819.mp3,He is a national ambassador for the United Cerebral Palsy Association.,10,0,male_masculine,10,6516
1355,401152,common_voice_en_104061.mp3,He reached over and picked up a shell from the ground.,10,0,male_masculine,10,4656
1356,498685,common_voice_en_37234551.mp3,Janet coined the term 'subconscious' to describe this part of the mind.,10,0,male_masculine,10,5796
1357,1093904,common_voice_en_38742817.mp3,Bush and President Ronald Reagan.,10,0,male_masculine,10,4284
1358,1093901,common_voice_en_38742814.mp3,The site is now a railway junction with concrete remnants of platforms.,10,0,male_masculine,10,6012
1359,1825431,common_voice_en_32313625.mp3,The applicant then sought judicial review.,10,0,male_masculine,10,4860
1360,1398512,common_voice_en_58489.mp3,I only interpret dreams.,10,0,male_masculine,10,1824
1361,697624,common_voice_en_23550.mp3,But they were not there.,10,0,male_masculine,10,2208
1362,486210,common_voice_en_20285309.mp3,The coast has numerous rocks and grottoes.,10,0,male_masculine,10,3912
1363,759970,common_voice_en_16604.mp3,A boy came running towards me.,10,0,male_masculine,10,3432
1364,417871,common_voice_en_20286104.mp3,"Moreover, Jesus assumed the form of Simon, and stood by laughing at them.",10,0,male_masculine,10,6336
1365,470817,common_voice_en_43119.mp3,This was the strangest of all things that ever came to earth from outer space.,10,0,male_masculine,10,4560
1366,590733,common_voice_en_35522.mp3,"To do that successfully, I must have no fear of failure.",10,0,male_masculine,10,3840
1367,1093905,common_voice_en_38742828.mp3,"They also have two sons and a further home in Croyde, Devon.",10,0,male_masculine,10,5472
1368,759988,common_voice_en_16622.mp3,The thought was so dreadful to him that he forgot about the heat and went forward.,11,1,male_masculine,10,4752
1369,772414,common_voice_en_13387.mp3,The time must have been somewhere around six o'clock.,10,0,male_masculine,10,4152
1370,1180277,common_voice_en_24465.mp3,They had gone away to breakfast at Henderson's house.,10,0,male_masculine,10,4512
1371,594886,common_voice_en_41645.mp3,The first rule of don't fight club is let's talk about it.,10,0,male_masculine,10,6264
1372,1181073,common_voice_en_32569430.mp3,He taught at Vanderbilt University for many years.,10,0,male_masculine,10,3888
1373,267928,common_voice_en_13892.mp3,"I'm an alchemist simply because I'm an alchemist, he said, as he prepared the meal.",10,0,male_masculine,10,5568
1374,267922,common_voice_en_13885.mp3,But horses tire bit by bit.,10,0,male_masculine,10,2904
1375,1436751,common_voice_en_33366815.mp3,All teams advanced to the first round.,10,0,male_masculine,10,3636
1376,1833215,common_voice_en_38306059.mp3,The greater size of the central figures mark them as divine.,10,0,male_masculine,10,4968
1377,859161,common_voice_en_16322.mp3,"Among these people were a couple of cyclists, a gardener I employed sometimes, and a girl carrying a baby.",10,0,male_masculine,10,7560
1378,354046,common_voice_en_35291.mp3,And he wasn't faring much better.,10,0,male_masculine,10,3864
1379,1278411,common_voice_en_20285456.mp3,The horrified trio are helplessly forced to watch her die.,10,0,male_masculine,10,6384
1380,784805,common_voice_en_32371819.mp3,It was overseen by Prime Minister Sheikh Hasina.,10,0,male_masculine,10,4896
1381,784807,common_voice_en_32371826.mp3,A brigadier wears gorget patches which are crimson patches with one golden star.,10,0,male_masculine,10,7632
1382,594890,common_voice_en_41649.mp3,It must have fallen while I was sitting over there.,10,0,male_masculine,10,4536
1383,1398791,common_voice_en_58777.mp3,But he granted the travelers three days.,10,0,male_masculine,10,3384
1384,268873,common_voice_en_38053031.mp3,"Many prisoners, including many children and women, died of typhus, starvation, and executions.",11,1,male_masculine,10,7848
1385,723437,common_voice_en_82862.mp3,They set off running wildly into the trees.,10,0,male_masculine,10,3984
1386,594897,common_voice_en_41656.mp3,"As I watched, the planet seemed to grow larger and smaller.",11,1,male_masculine,10,7488
1387,1278421,common_voice_en_20285571.mp3,Another problem is the lower level of light underwater.,10,0,male_masculine,10,5688
1388,1833191,common_voice_en_38305553.mp3,The gilded cow was carried around the temple seven times.,10,0,male_masculine,10,5796
1389,820420,common_voice_en_109576.mp3,Some storms are worth the wreckage.,10,0,male_masculine,10,2496
1390,772378,common_voice_en_13351.mp3,"I had the ""everyone has Gary Busey's teeth"" dream again.",12,2,male_masculine,10,5472
1391,1398732,common_voice_en_58718.mp3,"An army is coming, the boy said.",10,0,male_masculine,10,2472
1392,760013,common_voice_en_16647.mp3,That sobered him a little.,10,0,male_masculine,10,2856
1393,772406,common_voice_en_13379.mp3,No one seemed to have thought about it that night.,10,0,male_masculine,10,3408
1394,1833372,common_voice_en_38444922.mp3,I have a collection of stories in my coat pocket you may enjoy.,12,2,male_masculine,10,5940
1395,772401,common_voice_en_13374.mp3,It was only when I got this close to it that the strangeness of it was at all evident to me.,11,1,male_masculine,10,7080
1396,772400,common_voice_en_13373.mp3,He just got a new kite for his birthday.,10,0,male_masculine,10,3024
1397,1278439,common_voice_en_20286264.mp3,"Scientists believe earthquakes, volcanic activity, or explosions can be a trigger for such phenomenon.",10,0,male_masculine,10,8568
1398,1278438,common_voice_en_20285794.mp3,I'm a bit late.,10,0,male_masculine,10,3408
1399,772412,common_voice_en_13385.mp3,It looked like a rusty gas float.,10,0,male_masculine,10,2832
1400,772363,common_voice_en_13336.mp3,"My seven year resume gap is marked ""Not Drugs"".",10,0,male_masculine,10,4800
1401,772359,common_voice_en_13332.mp3,The first rule of don't fight club is let's talk about it.,10,0,male_masculine,10,4584
1402,772386,common_voice_en_13359.mp3,"The shop folks were taking down their shutters, and people were opening their bedroom windows.",10,0,male_masculine,10,5976
1403,772344,common_voice_en_13316.mp3,"Revenge is not my style, but obviously accidents will happen.",11,1,male_masculine,10,4872
1404,618468,common_voice_en_38896428.mp3,"Millers Point lies on the southern shore of Sydney Harbour, beside Darling Harbour.",10,0,male_masculine,10,6768
1405,780567,common_voice_en_9136.mp3,Yet each felt his heart beat a bit faster.,13,3,male_masculine,10,3456
1406,1763755,common_voice_en_36711463.mp3,The vinyl was housed in a gatefold-sleeve with photo-liners.,10,0,male_masculine,10,6336
1407,784806,common_voice_en_32371823.mp3,He also claimed that his phrases were distorted and taken out of context.,10,0,male_masculine,10,5652
1408,772367,common_voice_en_13340.mp3,My mind ran on the possibilities of its content.,10,0,male_masculine,10,4344
1409,780550,common_voice_en_9119.mp3,"One night, the father had a dream.",11,1,male_masculine,10,3576
1410,780585,common_voice_en_9155.mp3,"That's true, the boy thought.",12,2,male_masculine,10,2544
1411,142572,common_voice_en_35130118.mp3,The original Cafe Wha?,10,0,male_masculine,10,5832
1412,142573,common_voice_en_35130119.mp3,The group had a huge influence on the emerging free tekno subculture.,10,0,male_masculine,10,5976
1413,854050,common_voice_en_36472487.mp3,Complete details can be obtained from the nominating countries.,10,0,male_masculine,10,5976
1414,142574,common_voice_en_35130120.mp3,"Pyrford has three golf courses: Pyrford Golf Course, Wisley Golf Course and Traditions.",10,0,male_masculine,10,8928
1415,1180299,common_voice_en_24488.mp3,"What's the world's greatest lie? the boy asked, completely surprised.",10,0,male_masculine,10,4728
1416,628194,common_voice_en_11845.mp3,It was his heart that would tell him where his treasure was hidden.,10,0,male_masculine,10,4704
1417,759998,common_voice_en_16632.mp3,"Yet, it was a little too large for assurance.",10,0,male_masculine,10,3312
1418,1180268,common_voice_en_24456.mp3,The crowd swayed a little as I elbowed my way through.,10,0,male_masculine,10,3600
1419,852965,common_voice_en_30644140.mp3,Coleman Flowers connected Rush with Rev.,10,0,male_masculine,10,3564
1420,759977,common_voice_en_16611.mp3,And the sand and gravel had been flung violently in every direction.,10,0,male_masculine,10,4416
1421,628187,common_voice_en_11838.mp3,There was enough there to buy a lot of weapons.,11,1,male_masculine,10,3864
1422,628186,common_voice_en_11837.mp3,"That's a good luck omen, the Englishman said, after the fat Arab had gone out.",10,0,male_masculine,10,7488
1423,768258,common_voice_en_20970.mp3,"They never have to make any decisions, he thought.",11,1,male_masculine,10,3984
1424,1093958,common_voice_en_38745224.mp3,He studied at the Seminario Conciliar and at the University of Chile.,10,0,male_masculine,10,5868
1425,1093957,common_voice_en_38745222.mp3,He also founded the San Diego Math Circle.,10,0,male_masculine,10,4824
1426,759965,common_voice_en_16599.mp3,"Sadly, my dream of becoming a squirrel whisperer may never happen.",10,0,male_masculine,10,4536
1427,1093955,common_voice_en_38745205.mp3,The dance is primarily an act of performing quick and intricate footwork.,10,0,male_masculine,10,5220
1428,759963,common_voice_en_16597.mp3,"I was scared, but wasted no time in going out and crossing the bridge to the sand pits.",10,0,male_masculine,10,6336
1429,1827732,common_voice_en_35277284.mp3,"In Islam, the role of the family is very important.",10,0,male_masculine,10,3888
1430,1022479,common_voice_en_74485.mp3,How do I guess at the future?,10,0,male_masculine,10,2688
1431,943780,common_voice_en_115223.mp3,"Before guns were invented, armies had to throw bullets at each other and if a bullet touched you, you had to sit out until the next war.",10,0,male_masculine,10,6816
1432,357283,common_voice_en_13755.mp3,"Before long, maybe in just a few days, he would be at the Pyramids.",11,1,male_masculine,10,6744
1433,599056,common_voice_en_87561.mp3,I got drunk yesterday and thought I built a super computer.,10,0,male_masculine,10,3936
1434,610523,common_voice_en_38324877.mp3,Humen is a thriving city crowded with consumer goods factories.,10,0,male_masculine,10,6120
1435,721122,common_voice_en_72371.mp3,Henderson stood up with a spade in his hand.,10,0,male_masculine,10,3360
1436,1430340,common_voice_en_38153644.mp3,"However, canon law does not state so directly, but its abstract implies so.",10,0,male_masculine,10,4932
1437,1278431,common_voice_en_20285762.mp3,The township took its name from Rabbit Lake.,10,0,male_masculine,10,4920
1438,142570,common_voice_en_35130116.mp3,A classic and well established explanation is based on Clar's rule.,10,0,male_masculine,10,7524
1439,142571,common_voice_en_35130117.mp3,"The first Art of Noise album, Who's Afraid of the Art of Noise?",10,0,male_masculine,10,6372
1440,298556,common_voice_en_20284798.mp3,Smaller isles number in tens of thousands.,11,1,male_masculine,10,4824
1441,1833432,common_voice_en_38519081.mp3,"One was Meta, which was intended to be a spoken word label.",12,2,male_masculine,10,5940
1442,451565,common_voice_en_17028.mp3,There was no need to imprison them: the Arabs simply confiscated their horses.,10,0,male_masculine,10,5064
1443,304819,common_voice_en_20764.mp3,"When he was a child, that man wanted to travel, too.",12,2,male_masculine,10,4464
1444,161250,common_voice_en_43909.mp3,He just got a new kite for his birthday.,11,1,male_masculine,10,3024
1445,784840,common_voice_en_32372062.mp3,Louis Michel Thibault was probably the original architect.,10,0,male_masculine,10,6228
1446,1822594,common_voice_en_31069767.mp3,He is originally from Winnipeg.,10,0,male_masculine,10,3528
1447,784841,common_voice_en_32372063.mp3,Most of the blocks are constructed as public housing.,10,0,male_masculine,10,4680
1448,725554,common_voice_en_48518.mp3,"Air was either entering or escaping at the rim with a thin, sizzling sound.",10,0,male_masculine,10,6576
1449,772333,common_voice_en_13305.mp3,What had been next to him five minutes ago was now at the other side.,10,0,male_masculine,10,5184
1450,1278436,common_voice_en_20285792.mp3,Over time the station continued to lose listeners at an alarming rate.,10,0,male_masculine,10,6552
1451,725572,common_voice_en_48536.mp3,But that was simply because my eye was tired.,10,0,male_masculine,10,3816
1452,1707396,common_voice_en_38600322.mp3,"Shinobi's main weapon is a katana, and he can also attack with shurikens.",10,0,male_masculine,10,6984
1453,725527,common_voice_en_48489.mp3,I heard a faint movement under my feet.,10,0,male_masculine,10,4056
1454,1093789,common_voice_en_38739761.mp3,The county seat is Traverse City.,10,0,male_masculine,10,4140
1455,272869,common_voice_en_15941.mp3,"Many people in Berkshire, Surrey, and Middlesex must have seen it.",10,0,male_masculine,10,4224
1456,503415,common_voice_en_13006.mp3,But the boy never took his eye off his new friend.,10,0,male_masculine,10,3624
1457,1093788,common_voice_en_38739752.mp3,None of the shows in the lineup lasted beyond that season.,10,0,male_masculine,10,5220
1458,1093787,common_voice_en_38739751.mp3,The wand by which they are hurled must be of hazel.,10,0,male_masculine,10,5292
1459,1430746,common_voice_en_38164730.mp3,"This policy, known as ""superstar pricing"", ultimately failed.",12,2,male_masculine,10,6516
1460,1044674,common_voice_en_18921.mp3,"He was more confident in himself, though, and felt as though he could conquer the world.",10,0,male_masculine,10,5376
1461,697645,common_voice_en_23572.mp3,My mind ran on the possibilities of its content.,12,2,male_masculine,10,3576
1462,1093785,common_voice_en_38739744.mp3,"In the book, Mattie has her arm amputated due to the snakebite and break.",10,0,male_masculine,10,6192
1463,784888,common_voice_en_32372176.mp3,Kennedy won the National Apprentice title in his final year.,10,0,male_masculine,10,6480
1464,1093778,common_voice_en_38739700.mp3,"Wyborowa is produced from rye grain, using a double-step distillation process.",10,0,male_masculine,10,6588
1465,784887,common_voice_en_32372175.mp3,He would go on to achieve fame as an explorer of Africa.,10,0,male_masculine,10,6336
1466,1093783,common_voice_en_38739742.mp3,"He's done amazing videos, DeLonge said.",10,0,male_masculine,10,4320
1467,1044714,common_voice_en_18963.mp3,But arms cannot be drawn unless they also go into battle.,10,0,male_masculine,10,4344
1468,784855,common_voice_en_32372087.mp3,In the middle of the interior is the Bema.,10,0,male_masculine,10,5040
1469,1155818,common_voice_en_30134774.mp3,Besides theatre roles he has also appeared in films and television series.,10,0,male_masculine,10,6624
1470,784854,common_voice_en_32372086.mp3,The blast affecting buildings up to away.,10,0,male_masculine,10,5760
1471,1437561,common_voice_en_33077336.mp3,Amy meets election observer Buddy Calhoun in Nevada and they begin dating.,12,2,male_masculine,10,4968
1472,32088,common_voice_en_10429.mp3,This morning I found a calculator taped to my Wii.,10,0,male_masculine,10,4656
1473,849439,common_voice_en_31065838.mp3,Flowering mainly occurs from May to October.,10,0,male_masculine,10,4680
1474,409247,common_voice_en_18118249.mp3,Is it raining right now?,10,0,male_masculine,10,2496
1475,1093784,common_voice_en_38739743.mp3,"After a while, the mad confusion of the story inspires a complete apathy.",10,0,male_masculine,10,6588
1476,784851,common_voice_en_32372083.mp3,Promotion to the Dublin senior team followed.,10,0,male_masculine,10,4572
1477,784891,common_voice_en_32372190.mp3,Stecher served as deputy county attorney and then as chief deputy county attorney.,10,0,male_masculine,10,7560
1478,784832,common_voice_en_32372054.mp3,Staunton has worked with numerous illustrators.,10,0,male_masculine,10,4500
1479,849462,common_voice_en_31066851.mp3,He also supplied silver to the mint.,10,0,male_masculine,10,3708
1480,1121371,common_voice_en_36798862.mp3,The problem was corrected in later pressings.,12,2,male_masculine,10,4068
1481,784890,common_voice_en_32372189.mp3,The primary branches formed after pruning are more susceptible to attack.,10,0,male_masculine,10,6444
1482,849438,common_voice_en_31065836.mp3,Also occurs in Taiwan.,10,0,male_masculine,10,3816
1483,1093808,common_voice_en_38740522.mp3,Without question he was a staunch defender of the liberties of the English church.,10,0,male_masculine,10,6588
1484,503386,common_voice_en_12977.mp3,It was dropping off in flakes and raining down on the sand.,11,1,male_masculine,10,4536
1485,1822133,common_voice_en_30667763.mp3,The mill closed when the bush around it had been felled.,10,0,male_masculine,10,5760
1486,1160208,common_voice_en_17570673.mp3,Where did that come from?,10,0,male_masculine,10,1944
1487,1180156,common_voice_en_24342.mp3,"Don't say anything, Fatima interrupted.",10,0,male_masculine,10,3264
1488,1093805,common_voice_en_38740501.mp3,It featured the Handsome Furs song Repatriated.,10,0,male_masculine,10,4896
1489,1093804,common_voice_en_38740497.mp3,Middleton previously taught at the University of Birmingham and the Open University.,10,0,male_masculine,10,6408
1490,784836,common_voice_en_32372058.mp3,The film was first teased on social media.,15,5,male_masculine,10,4644
1491,1825513,common_voice_en_32356909.mp3,Others questioned whether it will truly help improve college access.,10,0,male_masculine,10,7056
1492,1093800,common_voice_en_38740489.mp3,Express trains operate from Yongsan and Seoul Stations to Dongincheon and Cheonan stations.,10,0,male_masculine,10,7416
1493,1093763,common_voice_en_38739559.mp3,The division retreated to Narva and participated in the battles for the Narva bridgehead.,10,0,male_masculine,10,7092
1494,1093762,common_voice_en_38739552.mp3,He currently works using heavy metals and making items for aircraft.,10,0,male_masculine,10,5724
1495,1093793,common_voice_en_38739765.mp3,The new program provides students with career pathways and academies.,10,0,male_masculine,10,5544
1496,1093792,common_voice_en_38739764.mp3,He is now a consultant for Buro Happold.,10,0,male_masculine,10,4212
1497,1093791,common_voice_en_38739763.mp3,The monastery consists of two courtyards surrounded by low buildings.,10,0,male_masculine,10,6156
1498,1831835,common_voice_en_37523958.mp3,Several of his books remain in print.,12,2,male_masculine,10,3528
1499,1044720,common_voice_en_18969.mp3,He wasn't asking for help.,10,0,male_masculine,10,2424
1500,697676,common_voice_en_23604.mp3,The time must have been somewhere around six o'clock.,11,1,male_masculine,10,3696
1501,849450,common_voice_en_31066764.mp3,The film stars Amanda Leyden and John Leyden in the lead roles.,10,0,male_masculine,10,5616
1502,204965,common_voice_en_11871.mp3,"The stranger placed his sword in its scabbard, and the boy relaxed.",10,0,male_masculine,10,5016
1503,849451,common_voice_en_31066765.mp3,She specialized in literary criticism of Southern literature.,10,0,male_masculine,10,5400
1504,849452,common_voice_en_31066766.mp3,This means that built in clocks in receivers can be precisely correct.,10,0,male_masculine,10,5688
1505,450845,common_voice_en_3408.mp3,"She would never know the difference, because she didn't know how to read.",10,0,male_masculine,10,5472
1506,963459,common_voice_en_21637.mp3,"As the Englishman left, Fatima arrived and filled her vessel with water.",10,0,male_masculine,10,6216
1507,204963,common_voice_en_11869.mp3,It made me very depressed.,10,0,male_masculine,10,2496
1508,1093761,common_voice_en_38739550.mp3,The provincial capital is Galkayo.,10,0,male_masculine,10,4104
1509,1180103,common_voice_en_24287.mp3,They never found the secret.,10,0,male_masculine,10,2424
1510,1702117,common_voice_en_30409189.mp3,She went on to study performing arts at Unitec.,10,0,male_masculine,10,5148
1511,849454,common_voice_en_31066798.mp3,Fire is often used to encourage the growth of young succulent grass shoots.,10,0,male_masculine,10,6120
1512,849455,common_voice_en_31066799.mp3,Yeskina is the nearest rural locality.,10,0,male_masculine,10,4068
1513,849456,common_voice_en_31066800.mp3,Calypso Baring (wife of Guy Maynard Liddell).,10,0,male_masculine,10,4716
1514,849457,common_voice_en_31066801.mp3,Ten nations won medals at the competition during its lifetime.,10,0,male_masculine,10,5616
1515,1093759,common_voice_en_38739548.mp3,The Wisconsin River and the Eagle River flow through the town.,10,0,male_masculine,10,4716
1516,849458,common_voice_en_31066822.mp3,He remained on the bench.,10,0,male_masculine,10,2736
1517,849459,common_voice_en_31066823.mp3,At the time he was the youngest member of the Assembly.,10,0,male_masculine,10,4500
1518,849460,common_voice_en_31066825.mp3,Alfred Earle.,10,0,male_masculine,10,2556
1519,175596,common_voice_en_65625.mp3,And he wasn't faring much better.,10,0,male_masculine,10,3144
1520,849453,common_voice_en_31066797.mp3,Apple Arcade is the perfect venue for this shared experience.,10,0,male_masculine,10,5256
1521,849441,common_voice_en_31065841.mp3,He was beaten mercilessly.,10,0,male_masculine,10,3240
1522,784853,common_voice_en_32372085.mp3,Four bridges totally collapsed.,10,0,male_masculine,10,3924
1523,1044730,common_voice_en_18979.mp3,I locked eyes with a fish in the tank.,10,0,male_masculine,10,3264
1524,849442,common_voice_en_31065842.mp3,"The track ""celebrates the strength of the human spirit as it overcomes adversity"".",10,0,male_masculine,10,6660
1525,849443,common_voice_en_31066703.mp3,The headquarters was in Copenhagen.,10,0,male_masculine,10,3600
1526,1702178,common_voice_en_30409289.mp3,He has written two books.,12,2,male_masculine,10,2916
1527,1301608,common_voice_en_31193282.mp3,It has also been put on hold.,10,0,male_masculine,10,3600
1528,849444,common_voice_en_31066706.mp3,Cabrera has conducted research regarding the development of decision support tools.,10,0,male_masculine,10,6660
1529,849477,common_voice_en_31066956.mp3,Blodgett grew up welding.,10,0,male_masculine,10,2880
1530,1093769,common_voice_en_38739616.mp3,"After several days, the General and his entourage set off for Turbaco.",10,0,male_masculine,10,6696
1531,784883,common_voice_en_32372161.mp3,Goodman attended La Salle College Prep in Oregon.,10,0,male_masculine,10,4320
1532,784831,common_voice_en_32372052.mp3,Where is this storage farm located?,10,0,male_masculine,10,4356
1533,862639,common_voice_en_36537634.mp3,It took a while for it to be widely adopted.,10,0,male_masculine,10,3276
1534,849479,common_voice_en_31066958.mp3,The elder Francis Peabody was president of the American Insurance Company.,10,0,male_masculine,10,6480
1535,1830812,common_voice_en_36989967.mp3,"She had received the role after appearing on the Australian reality show ""Dream Factory"".",10,0,male_masculine,10,7668
1536,1044749,common_voice_en_18999.mp3,You brought a new feeling into my crystal shop.,10,0,male_masculine,10,3264
1537,849448,common_voice_en_31066762.mp3,Their results were expunged.,10,0,male_masculine,10,3168
1538,580719,common_voice_en_69175.mp3,I think they perceived that nothing was to be done at the moment.,11,1,male_masculine,10,3840
1539,784884,common_voice_en_32372172.mp3,Most of the film was shot on location in Russia.,10,0,male_masculine,10,4860
1540,849449,common_voice_en_31066763.mp3,It is open for use for weddings and other events.,10,0,male_masculine,10,4536
1541,282494,common_voice_en_38187073.mp3,Roger Dean's logo for the band continues to be used on every release.,10,0,male_masculine,10,5976
1542,844012,common_voice_en_12068.mp3,"At once, he connected the two incidents.",10,0,male_masculine,10,4944
1543,849478,common_voice_en_31066957.mp3,The pond is managed for both angling and wildlife.,10,0,male_masculine,10,4320
1544,331586,common_voice_en_32792.mp3,Henderson was taking it in.,10,0,male_masculine,10,2904
1545,1044637,common_voice_en_18883.mp3,The woman was silent for some time.,10,0,male_masculine,10,2616
1546,1093811,common_voice_en_38740534.mp3,"He is part of Office Kitano, the production company of Takeshi Kitano.",10,0,male_masculine,10,7380
1547,1093810,common_voice_en_38740532.mp3,Its remnants persisted another day before last being noted southwest of Guatemala.,10,0,male_masculine,10,7128
1548,1093841,common_voice_en_38740739.mp3,A library is a sanatorium of sick minds.,10,0,male_masculine,10,4824
1549,1044622,common_voice_en_18868.mp3,"On the second day, the boy climbed to the top of a cliff near the camp.",10,0,male_masculine,10,4464
1550,784850,common_voice_en_32372082.mp3,Smith is currently an education student at Wilfrid Laurier University.,10,0,male_masculine,10,6192
1551,1093838,common_voice_en_38740682.mp3,"Besides being the only recurring female character, she is also the only named character.",10,0,male_masculine,10,7272
1552,975063,common_voice_en_18447.mp3,A group of people rowing down a muddy river in large boats.,10,0,male_masculine,10,3384
1553,849447,common_voice_en_31066711.mp3,He was active in Crete.,10,0,male_masculine,10,2736
1554,323509,common_voice_en_8596.mp3,"Sometimes I appear in the form of a solution, or a good idea.",10,0,male_masculine,10,5064
1555,450847,common_voice_en_3410.mp3,"When he reached the top of the dune, his heart leapt.",10,0,male_masculine,10,5568
1556,1044628,common_voice_en_18874.mp3,He prepared himself a sandwich and drank some hot tea from a crystal glass.,10,0,male_masculine,10,4824
1557,490583,common_voice_en_93075.mp3,"Relaxed and unhurried, he resolved that he would walk through the narrow streets of Tangier.",10,0,male_masculine,10,7776
1558,453208,common_voice_en_45278.mp3,No doubt the impact had caused a flash of fire.,10,0,male_masculine,10,4344
1559,849445,common_voice_en_31066708.mp3,Krasnaya Ushna is the nearest rural locality.,10,0,male_masculine,10,4536
1560,849446,common_voice_en_31066710.mp3,He practiced law in Chicago.,10,0,male_masculine,10,3240
1561,700201,common_voice_en_20208.mp3,I found a little crowd of about twenty people surrounding the huge hole.,10,0,male_masculine,10,4104
1562,1398910,common_voice_en_58900.mp3,The merchant turned to a customer who wanted three crystal glasses.,10,0,male_masculine,10,3936
1563,700220,common_voice_en_20227.mp3,"He knew what I was thinking, the boy said to himself.",11,1,male_masculine,10,3096
1564,982702,common_voice_en_31443724.mp3,The number of foreign players is restricted to five per team.,10,0,male_masculine,10,5436
1565,1833687,common_voice_en_38776319.mp3,"Regarding disease, cancer is much less common in young than in older adults.",10,0,male_masculine,10,6228
1566,1093869,common_voice_en_38741448.mp3,"The term bankruptcy applies only to individuals, not to companies or other legal entities.",10,0,male_masculine,10,6768
1567,965949,common_voice_en_18270965.mp3,A spark can start a great fire.,10,0,male_masculine,10,4224
1568,1093866,common_voice_en_38741421.mp3,"Barbeques, picnic shelters, untreated water and rubbish bins are provided.",10,0,male_masculine,10,6912
1569,1437618,common_voice_en_33696370.mp3,She also raised some of her many grandchildren.,10,0,male_masculine,10,4428
1570,801129,common_voice_en_17164.mp3,"We're refugees from the tribal wars, and we need money, the other figure said.",10,0,male_masculine,10,5064
1571,1093856,common_voice_en_38741322.mp3,"Neely is featured in the documentary ""We Are Wizards"".",10,0,male_masculine,10,4716
1572,1093855,common_voice_en_38741320.mp3,The leaves close up and droop when touched.,10,0,male_masculine,10,3996
1573,975027,common_voice_en_18410.mp3,A man in a white helmet and dark clothing stands in the snowy mountains.,10,0,male_masculine,10,4536
1574,1093853,common_voice_en_38741312.mp3,The Secretariat is permanently hosted by Tsinghua University.,10,0,male_masculine,10,5292
1575,942399,common_voice_en_38627430.mp3,It is currently the only theatre in Canada exclusively devoted to puppetry performance.,10,0,male_masculine,10,6408
1576,1093852,common_voice_en_38741308.mp3,"Its construction was started, but was soon stopped due to the French occupation.",10,0,male_masculine,10,5400
1577,1430627,common_voice_en_38159449.mp3,It is named after Vinayak Damodar Savarkar.,10,0,male_masculine,10,5508
1578,1044614,common_voice_en_18860.mp3,He really was a king!,10,0,male_masculine,10,2376
1579,1398133,common_voice_en_58102.mp3,This morning I found a calculator taped to my Wii.,10,0,male_masculine,10,3720
1580,355686,common_voice_en_18050.mp3,"You should see the other guy, specifically, how good at fighting he is.",10,0,male_masculine,10,4416
1581,784835,common_voice_en_32372057.mp3,"It communicates with the ""Perseverance"" rover directly before and after each landing.",10,0,male_masculine,10,8640
1582,401123,common_voice_en_36919366.mp3,On my arrival at the gate I found that the doctor was absent.,10,0,male_masculine,10,4824
1583,1093854,common_voice_en_38741319.mp3,Several refuse pits uncovered by excavators contained Cherokee artifacts.,10,0,male_masculine,10,6372
1584,784886,common_voice_en_32372174.mp3,Additional modes like dungeons to explore are set to be released in future updates.,10,0,male_masculine,10,7596
1585,1044659,common_voice_en_18905.mp3,"If I don't find it, I can always go home.",10,0,male_masculine,10,3504
1586,228867,common_voice_en_20285769.mp3,The concept never reached production.,10,0,male_masculine,10,3672
1587,1093822,common_voice_en_38740592.mp3,"Females are drab-coloured, being dull brownish above, and white below with strong dark streaking.",10,0,male_masculine,10,7704
1588,228865,common_voice_en_20285767.mp3,The relationship between Karen and Denys develops and he comes to live with her.,11,1,male_masculine,10,5208
1589,784871,common_voice_en_32372133.mp3,The Benghazi protestors were attacked by Haftar supporters and one organiser went missing.,10,0,male_masculine,10,9684
1590,355677,common_voice_en_18041.mp3,"Then he dropped his spade, picked up his jacket, and came out into the road.",10,0,male_masculine,10,5568
1591,700225,common_voice_en_20232.mp3,He knew all the fields and pastures of Andalusia.,10,0,male_masculine,10,3336
1592,784885,common_voice_en_32372173.mp3,"That recording is regarded as the ""most famous duet in jazz history"".",10,0,male_masculine,10,6372
1593,1093796,common_voice_en_38740468.mp3,The disaster is announced by placards posted about the streets in the evening.,10,0,male_masculine,10,6444
1594,1093797,common_voice_en_38740470.mp3,That year he was voted the Tour's comeback player of the year.,10,0,male_masculine,10,4860
1595,1180195,common_voice_en_24383.mp3,"I'll just watch him, he said to himself.",10,0,male_masculine,10,2592
1596,1093798,common_voice_en_38740472.mp3,"Note: Only official results are listed, invalid jumps are not included.",10,0,male_masculine,10,6480
1597,784834,common_voice_en_32372056.mp3,The unit was based in Sundsvall.,10,0,male_masculine,10,4068
1598,1093803,common_voice_en_38740496.mp3,He became the acknowledged leader of Reform Judaism in America.,10,0,male_masculine,10,5112
1599,1823644,common_voice_en_31473965.mp3,Slave labor in these areas made the black population grow slowly.,10,0,male_masculine,10,5508
1600,1437580,common_voice_en_33296903.mp3,He earned both an undergraduate degree and law degree from the University of Alabama.,10,0,male_masculine,10,6336
1601,1093819,common_voice_en_38740577.mp3,"Incensed by the tactic, Parks accused Cornyn of trying to kill his career.",10,0,male_masculine,10,6984
1602,784892,common_voice_en_32372191.mp3,It is the great molding force of mind and character.,10,0,male_masculine,10,6336
1603,172247,common_voice_en_18798.mp3,"The war is going to end someday, the girl said.",9,0,male_masculine,9,4704
1604,625396,common_voice_en_34213553.mp3,Mountain tundra of shrubs and lichens grows in the highest summits.,9,0,male_masculine,9,4320
1605,1561184,common_voice_en_20457539.mp3,The video stars British actress Keeley Hawes.,9,0,male_masculine,9,3288
1606,1180077,common_voice_en_24261.mp3,"The following night, the boy appeared at the alchemist's tent with a horse.",10,1,male_masculine,9,4944
1607,341489,common_voice_en_18816.mp3,"The owner of the bar came over and looked, as well.",9,0,male_masculine,9,4344
1608,1563769,common_voice_en_26267334.mp3,Another difficulty is the low luminosity during part of the year.,9,0,male_masculine,9,3996
1609,1180097,common_voice_en_24281.mp3,The sun was turned into a golden disk.,9,0,male_masculine,9,3000
1610,290663,common_voice_en_32667290.mp3,The gardens form some of the collection of New Town Gardens.,9,0,male_masculine,9,4608
1611,1398239,common_voice_en_58213.mp3,"Another, who was searching the boy's bags, found the piece of gold.",9,0,male_masculine,9,3744
1612,1180171,common_voice_en_24359.mp3,His name was Joseph.,9,0,male_masculine,9,2448
1613,323516,common_voice_en_8603.mp3,"We miss you and miss having a friend like you, and I am so happy that you two got to catch up.",10,1,male_masculine,9,7224
1614,1398277,common_voice_en_58251.mp3,"When the lead had become liquid, the alchemist took from his pouch the strange yellow egg.",9,0,male_masculine,9,5664
1615,652116,common_voice_en_34836.mp3,But arms cannot be drawn unless they also go into battle.,9,0,male_masculine,9,5064
1616,1180233,common_voice_en_24421.mp3,And one or two persons were returning.,9,0,male_masculine,9,2736
1617,1398151,common_voice_en_58122.mp3,The end of the cylinder was still as Ogilvy and Henderson had left it.,9,0,male_masculine,9,4944
1618,1022645,common_voice_en_74651.mp3,The alchemist probably already knew all that.,9,0,male_masculine,9,2616
1619,1180213,common_voice_en_24401.mp3,Everyone seemed very excited.,9,0,male_masculine,9,2688
1620,1415729,common_voice_en_37282007.mp3,The region except for Malaysia is predominantly Buddhist.,9,0,male_masculine,9,4500
1621,1415783,common_voice_en_37289471.mp3,"Techiman is connected by road to Sunyani and its domestic airport, the Sunyani Airport.",9,0,male_masculine,9,7416
1622,1368265,common_voice_en_33392547.mp3,Its habitat is in dry areas.,9,0,male_masculine,9,4176
1623,1398330,common_voice_en_58305.mp3,This wasn't a strange place; it was a new one.,9,0,male_masculine,9,2760
1624,992021,common_voice_en_149523.mp3,Everyone seemed very excited.,9,0,male_masculine,9,2616
1625,1180238,common_voice_en_24426.mp3,"You shouldn't be here, the alchemist answered.",10,1,male_masculine,9,3240
1626,562610,common_voice_en_20531395.mp3,The tidal wave starts far out in mid-ocean.,9,0,male_masculine,9,4416
1627,1180175,common_voice_en_24363.mp3,"Trust in your heart, but never forget that you're in the desert.",9,0,male_masculine,9,3792
1628,1416273,common_voice_en_37306438.mp3,He also plays at centre half back for his club.,9,0,male_masculine,9,4716
1629,1157910,common_voice_en_44870.mp3,"Some went away while I was there, and other people came.",9,0,male_masculine,9,3024
1630,1415718,common_voice_en_37281924.mp3,"It contained Edmonton's western and northwestern suburbs, including the city of Saint Albert.",9,0,male_masculine,9,9360
1631,882231,common_voice_en_17391611.mp3,The president of Russia is Vladimir Putin.,9,0,male_masculine,9,3264
1632,1278409,common_voice_en_20285453.mp3,He participated in Mitchel's operations along the Memphis and Chattanooga Railroad.,9,0,male_masculine,9,7152
1633,1398285,common_voice_en_58259.mp3,"You are almost at the end of your journey, said the alchemist.",9,0,male_masculine,9,3576
1634,1180176,common_voice_en_24364.mp3,"The boy prodded them, one by one, with his crook, calling each by name.",9,0,male_masculine,9,4560
1635,201660,common_voice_en_20906.mp3,It was only when I got this close to it that the strangeness of it was at all evident to me.,9,0,male_masculine,9,6264
1636,201659,common_voice_en_20905.mp3,Absolutely despicable that gingerbread men are forced to live in houses made of their own flesh.,9,0,male_masculine,9,6936
1637,1415703,common_voice_en_37281865.mp3,He is sponsored by Unite the Union.,9,0,male_masculine,9,5688
1638,1157876,common_voice_en_44835.mp3,"I pointed out Mars, a bright dot of light.",10,1,male_masculine,9,2184
1639,742442,common_voice_en_30702851.mp3,The walls of the room are thick and are made of rock and limestone.,9,0,male_masculine,9,4968
1640,1415381,common_voice_en_37280771.mp3,They found themselves accused of taking the souls of the natives.,9,0,male_masculine,9,4140
1641,1161949,common_voice_en_36827531.mp3,Results depend on the underlying pathology and the skill of the surgeon.,9,0,male_masculine,9,4932
1642,331572,common_voice_en_32778.mp3,I think they perceived that nothing was to be done at the moment.,10,1,male_masculine,9,4632
1643,652110,common_voice_en_34830.mp3,"It is I, the boy answered.",9,0,male_masculine,9,2904
1644,323507,common_voice_en_8594.mp3,It was such a gradual movement that he found it only by noticing the dots.,9,0,male_masculine,9,5544
1645,1316498,common_voice_en_20286309.mp3,Most of the original Ulster fifers were of Flemish descent.,9,0,male_masculine,9,5736
1646,1316496,common_voice_en_20286279.mp3,More widespread has been organized workplace canvasses either by labour unions or by employers.,10,1,male_masculine,9,8592
1647,248185,common_voice_en_32717586.mp3,Mabuchi is known for introducing the Mabuchi functional.,9,0,male_masculine,9,6300
1648,992034,common_voice_en_149536.mp3,Most of them were staring quietly at the big table.,9,0,male_masculine,9,3624
1649,490570,common_voice_en_93062.mp3,"I'd like to build a display case for the crystal, the boy said to the merchant.",9,0,male_masculine,9,7128
1650,1368279,common_voice_en_33392631.mp3,Expropriation was managed by various government ministries.,9,0,male_masculine,9,7056
1651,1397984,common_voice_en_57951.mp3,"There is no wine in this country, the young man said.",9,0,male_masculine,9,3408
1652,357280,common_voice_en_13752.mp3,It seemed he had made the long journey for nothing.,9,0,male_masculine,9,5136
1653,1180111,common_voice_en_24295.mp3,"You have helped me. The man continued to prepare his tea, saying nothing.",11,2,male_masculine,9,5664
1654,323515,common_voice_en_8602.mp3,"Go back to watching the caravan, he said.",9,0,male_masculine,9,3384
1655,1095272,common_voice_en_32442935.mp3,He currently lives in Los Angeles and New York City.,9,0,male_masculine,9,5976
1656,1563690,common_voice_en_20934923.mp3,The Toowong Railway Station is also located in the base of the building.,9,0,male_masculine,9,5064
1657,1095289,common_voice_en_32442971.mp3,It is considered to be one of his best known works.,9,0,male_masculine,9,4896
1658,527158,common_voice_en_153763.mp3,"For at that time, it had not occurred to him that it might be hollow.",9,0,male_masculine,9,4680
1659,1095284,common_voice_en_32442966.mp3,Nasty Jack then kidnaps Piglet.,9,0,male_masculine,9,4248
1660,451562,common_voice_en_17024.mp3,He remembered the sword.,9,0,male_masculine,9,2256
1661,201661,common_voice_en_20907.mp3,"You don't have to be rich, skinny, popular, or even own a cape to perform a random act of kindness.",9,0,male_masculine,9,8136
1662,590732,common_voice_en_35521.mp3,The oasis is neutral ground.,9,0,male_masculine,9,2280
1663,1563675,common_voice_en_20934883.mp3,This is exceptional for an artist in Quebec.,9,0,male_masculine,9,3264
1664,777404,common_voice_en_17759266.mp3,Why are you doing this?,9,0,male_masculine,9,2376
1665,742452,common_voice_en_30702865.mp3,After the first world war Lena Ashwell was delivering subsidised theatre around London.,9,0,male_masculine,9,6588
1666,594879,common_voice_en_41638.mp3,"For at that time, it had not occurred to him that it might be hollow.",10,1,male_masculine,9,6648
1667,1157919,common_voice_en_44880.mp3,"There were raised voices,and some sort of struggle appeared to be going on. .",9,0,male_masculine,9,3216
1668,594885,common_voice_en_41644.mp3,But I found it difficult to get to work because of the investigations.,9,0,male_masculine,9,6768
1669,594887,common_voice_en_41646.mp3,"My seven year resume gap is marked ""Not Drugs"".",9,0,male_masculine,9,6192
1670,1161905,common_voice_en_36518047.mp3,His grave gives details of his many famous pupils and accomplishments.,9,0,male_masculine,9,5868
1671,1368301,common_voice_en_33392966.mp3,Annunziata holds board certification for the practice of medical oncology.,9,0,male_masculine,9,7740
1672,1563652,common_voice_en_20922296.mp3,There is a yearly Spring Tide Festival on the beach.,9,0,male_masculine,9,3504
1673,1180256,common_voice_en_24444.mp3,"The level ground was blackened as far as one could see, and it was still giving off smoke.",10,1,male_masculine,9,5136
1674,1180235,common_voice_en_24423.mp3,He was going to miss the place and all the good things he had learned.,9,0,male_masculine,9,4224
1675,1180206,common_voice_en_24394.mp3,"First, they tried to find him on their own.",9,0,male_masculine,9,3168
1676,1563764,common_voice_en_20965441.mp3,In front of it there is a large lawn where demonstrations take place.,9,0,male_masculine,9,4704
1677,1025411,common_voice_en_20280541.mp3,George Hudson is a voluntary special advisor to the Board.,9,0,male_masculine,9,5976
1678,1157794,common_voice_en_44751.mp3,The top had certainly ceased to rotate.,9,0,male_masculine,9,2184
1679,1180241,common_voice_en_24429.mp3,"That's not true, the boy said.",9,0,male_masculine,9,3192
1680,1022612,common_voice_en_74618.mp3,"At the highest point in Tarifa there is an old fort, built by the Moors.",9,0,male_masculine,9,4464
1681,109154,common_voice_en_17417492.mp3,What does she look like?,9,0,male_masculine,9,2256
1682,943852,common_voice_en_115296.mp3,The top of the cylinder was rotating on its body.,9,0,male_masculine,9,2976
1683,1367721,common_voice_en_32234248.mp3,The album was produced in part by Jimmy Jam and Terry Lewis.,9,0,male_masculine,9,4788
1684,1285582,common_voice_en_31501937.mp3,The doubling of this section is under process.,9,0,male_masculine,9,4968
1685,760023,common_voice_en_16657.mp3,"My wife pointed out to me the brightness of the red, green, and yellow signal lights.",9,0,male_masculine,9,4704
1686,1285618,common_voice_en_31501975.mp3,Both sides appealed to the ruling.,9,0,male_masculine,9,3708
1687,598309,common_voice_en_32642546.mp3,The following year he emigrated to the United States.,9,0,male_masculine,9,4068
1688,628163,common_voice_en_11814.mp3,Where are you bound? asked the young Arab.,12,3,male_masculine,9,3864
1689,628164,common_voice_en_11815.mp3,"Because for him, you are a green field, from which he always returns with game.",11,2,male_masculine,9,6792
1690,1367708,common_voice_en_32234147.mp3,The couple was buried in Montparnasse Cemetery.,9,0,male_masculine,9,4500
1691,628167,common_voice_en_11818.mp3,The merchant was silent for a few moments.,10,1,male_masculine,9,3504
1692,955673,common_voice_en_37944625.mp3,Hyrcanus advanced against him at the head of his mercenaries and his followers.,9,0,male_masculine,9,6984
1693,319794,common_voice_en_17654741.mp3,But what are we to do?,9,0,male_masculine,9,1728
1694,385778,common_voice_en_24541.mp3,It was faintly marked with transverse stripes and slightly flattened from the perfect round.,9,0,male_masculine,9,5976
1695,652123,common_voice_en_34843.mp3,I found these one day in the fields.,10,1,male_masculine,9,3384
1696,385776,common_voice_en_24539.mp3,"We don't know what's in the confounded thing, do you?",10,1,male_masculine,9,3840
1697,385767,common_voice_en_24530.mp3,They formed heaps that are visible a mile and a half away.,9,0,male_masculine,9,3504
1698,1285647,common_voice_en_31502009.mp3,This led to the creation of the fourth largest railway system in the world.,9,0,male_masculine,9,6336
1699,246856,common_voice_en_30526929.mp3,The latter are spoken in the easternmost part of Jilin province.,9,0,male_masculine,9,4572
1700,843935,common_voice_en_11991.mp3,"The snake fought frantically, making hissing sounds that shattered the silence of the desert.",9,0,male_masculine,9,7800
1701,759960,common_voice_en_16594.mp3,I would have won the Junior Olympics if not for those medaling kids.,10,1,male_masculine,9,4848
1702,1285650,common_voice_en_31502012.mp3,The competition featured both junior and senior competitive divisions.,9,0,male_masculine,9,6480
1703,919081,common_voice_en_32640208.mp3,Specialists handed it over to the Research and Development Geological Enterprise of Alrosa.,9,0,male_masculine,9,8208
1704,1285652,common_voice_en_31502014.mp3,The complex was the headquarters of Barrhead Burgh Council.,12,3,male_masculine,9,5040
1705,919082,common_voice_en_32640209.mp3,It publishes works by both contemporary authors and classic genre writers of the past.,9,0,male_masculine,9,8064
1706,919085,common_voice_en_32640224.mp3,His loan was subsequently extended for another season.,9,0,male_masculine,9,5724
1707,385772,common_voice_en_24535.mp3,"You should see the other guy, specifically, how good at fighting he is.",9,0,male_masculine,9,4944
1708,759999,common_voice_en_16633.mp3,"I remember how I sat on the table there in the blackness, with patches of green and crimson swimming before my eyes.",10,1,male_masculine,9,7440
1709,1285658,common_voice_en_31502021.mp3,Her parents were Maria (born Field) and William Hughes Hughes.,9,0,male_masculine,9,6300
1710,628171,common_voice_en_11822.mp3,"If I'm on the march, I just concentrate on marching.",10,1,male_masculine,9,4536
1711,700219,common_voice_en_20226.mp3,"It's not what enters men's mouths that's evil, said the alchemist.",9,0,male_masculine,9,3432
1712,700231,common_voice_en_20238.mp3,He picked up the two stones and put them back in his pouch.,10,1,male_masculine,9,3816
1713,355687,common_voice_en_18051.mp3,That sobered him a little.,10,1,male_masculine,9,2472
1714,375970,common_voice_en_34085.mp3,"The boy knew, and was now working toward it.",10,1,male_masculine,9,3336
1715,1367776,common_voice_en_32234687.mp3,It has hosted the Scandinavian Enterprise Open on the European Tour.,9,0,male_masculine,9,5868
1716,700237,common_voice_en_20244.mp3,It reminded him of the wool from his sheep...,10,1,male_masculine,9,2592
1717,801128,common_voice_en_17163.mp3,Maybe these desert birds could explain to him the meaning of love without ownership.,9,0,male_masculine,9,5904
1718,1069970,common_voice_en_18061123.mp3,A good book informs of what we ought to know.,9,0,male_masculine,9,4296
1719,1095331,common_voice_en_32443179.mp3,Information is collected from you when you register on our site.,9,0,male_masculine,9,6156
1720,1285576,common_voice_en_31501931.mp3,She faces Green Party challenger Scott Hutchins in the general election.,9,0,male_masculine,9,6156
1721,801135,common_voice_en_17170.mp3,The woman was silent for some time.,9,0,male_masculine,9,3744
1722,801136,common_voice_en_17171.mp3,But he certainly didn't desire that an army invade the oasis.,9,0,male_masculine,9,4824
1723,801145,common_voice_en_17181.mp3,And he gave the boy his blessing.,9,0,male_masculine,9,2856
1724,1367727,common_voice_en_32234275.mp3,Flacco has five older siblings.,9,0,male_masculine,9,3456
1725,801148,common_voice_en_17184.mp3,"Then he sat in the sun-filled doorway, smoking the hookah.",9,0,male_masculine,9,4320
1726,801151,common_voice_en_17187.mp3,"Maybe we're all that way, the boy mused.",9,0,male_masculine,9,3288
1727,508890,common_voice_en_9535.mp3,"After all, he had all his money.",10,1,male_masculine,9,3240
1728,1285592,common_voice_en_31501947.mp3,Hickman and his wife Lucy were the parents of six children.,9,0,male_masculine,9,5400
1729,1162058,common_voice_en_37627702.mp3,He was regent of the Wisconsin state normal schools.,9,0,male_masculine,9,5328
1730,919037,common_voice_en_32639904.mp3,Only private masses would be allowed in the archdiocese during that time period.,9,0,male_masculine,9,7164
1731,801173,common_voice_en_17209.mp3,"There are rumors of tribal wars, he told them.",9,0,male_masculine,9,4176
1732,508902,common_voice_en_9547.mp3,"The stranger placed his sword in its scabbard, and the boy relaxed.",9,0,male_masculine,9,5328
1733,801205,common_voice_en_17241.mp3,"It's true; life really is generous to those who pursue their destiny, the boy thought.",9,0,male_masculine,9,4896
1734,140222,common_voice_en_12941.mp3,"They looked for the fallen mass, but found nothing.",12,3,male_masculine,9,4104
1735,1095341,common_voice_en_32443240.mp3,The road board met in the municipal chambers of the Municipality of Bunbury.,9,0,male_masculine,9,6876
1736,1561372,common_voice_en_20593361.mp3,"Some programming is also available on the digital ""Rogers On Demand"" service.",9,0,male_masculine,9,4968
1737,801215,common_voice_en_17251.mp3,"Today, I understand something I didn't see before: every blessing ignored becomes a curse.",9,0,male_masculine,9,7224
1738,801219,common_voice_en_17255.mp3,The shop is exactly the size I always wanted it to be.,9,0,male_masculine,9,3624
1739,919058,common_voice_en_32640125.mp3,The song received positive critical reviews.,9,0,male_masculine,9,5220
1740,768842,common_voice_en_38383400.mp3,"Like tallow, this was derived from animals, but had no glycerine content.",9,0,male_masculine,9,7128
1741,1095481,common_voice_en_32459941.mp3,The same could be said for its star.,9,0,male_masculine,9,4608
1742,483185,common_voice_en_15173.mp3,"He told Fatima that, at their next meeting.",9,0,male_masculine,9,4224
1743,210485,common_voice_en_33150768.mp3,His father is the town sheriff.,9,0,male_masculine,9,3456
1744,722185,common_voice_en_36305201.mp3,I wish my father were back again.,9,0,male_masculine,9,3348
1745,267930,common_voice_en_13896.mp3,"In one he had read that, many years ago, a famous Arabian alchemist had visited Europe.",9,0,male_masculine,9,6384
1746,722200,common_voice_en_36305268.mp3,The lake borders many of its settlements and is used for several purposes.,9,0,male_masculine,9,5616
1747,943767,common_voice_en_115209.mp3,"Coming home, a party of tourists passed us, singing and playing music.",9,0,male_masculine,9,4368
1748,516339,common_voice_en_32145181.mp3,We are very vulnerable and we had to be included in some risk group.,9,0,male_masculine,9,5976
1749,768783,common_voice_en_35113726.mp3,"These include a diversity of grasses, herbs, trees, birds, mammals and amphibians.",9,0,male_masculine,9,6948
1750,1285696,common_voice_en_31502060.mp3,"Anne Palles has been called the last ""witch"" to be executed in Denmark.",9,0,male_masculine,9,6156
1751,768810,common_voice_en_35892906.mp3,Put the enclosed scraps in the drawer.,9,0,male_masculine,9,3960
1752,722228,common_voice_en_36313105.mp3,"To compensate, they sometimes assaulted them in armoured sledges towed by tanks.",9,0,male_masculine,9,6264
1753,1573,common_voice_en_18184708.mp3,"Please use normal slashes, not backslashes.",9,0,male_masculine,9,4104
1754,759994,common_voice_en_16628.mp3,They set off running wildly into the trees.,9,0,male_masculine,9,3504
1755,1095410,common_voice_en_32444884.mp3,The action was condemned by international Arabic newspapers in London and Lebanon.,9,0,male_masculine,9,8496
1756,1767325,common_voice_en_18016139.mp3,Wine is not an emulator.,9,0,male_masculine,9,2472
1757,772384,common_voice_en_13357.mp3,Everyone seemed very excited.,9,0,male_masculine,9,3216
1758,760006,common_voice_en_16640.mp3,"As I watched, the planet seemed to grow larger and smaller.",9,0,male_masculine,9,4104
1759,760007,common_voice_en_16641.mp3,Now I will drift gently off to dreamland.,9,0,male_masculine,9,4272
1760,780562,common_voice_en_9131.mp3,Then you'll die in the midst of trying to realize your destiny.,10,1,male_masculine,9,4776
1761,760009,common_voice_en_16643.mp3,The turf and gravel around it seemed charred as if by a sudden explosion.,10,1,male_masculine,9,5328
1762,780600,common_voice_en_9170.mp3,The people will enjoy the tea and want to buy the glasses.,14,5,male_masculine,9,3504
1763,760010,common_voice_en_16644.mp3,"We don't know what's in the confounded thing, do you?",9,0,male_masculine,9,3696
1764,780605,common_voice_en_9175.mp3,"Let's, the alchemist answered.",12,3,male_masculine,9,2976
1765,760012,common_voice_en_16646.mp3,He heard a muffled grating sound and saw the black mark jerk forward an inch or so.,11,2,male_masculine,9,6096
1766,772410,common_voice_en_13383.mp3,"Besides that, there was a heap of bicycles.",9,0,male_masculine,9,4248
1767,722210,common_voice_en_36305303.mp3,"The winner will be provided with a long-term lease, subject to redevelopment.",9,0,male_masculine,9,5724
1768,780592,common_voice_en_9162.mp3,There was a hole there among the stones.,11,2,male_masculine,9,2424
1769,759973,common_voice_en_16607.mp3,"The heather was on fire, and you could see a thin blue smoke rising up slowly.",9,0,male_masculine,9,6312
1770,1095373,common_voice_en_32443460.mp3,Winston and her husband Ira have two children together.,9,0,male_masculine,9,6876
1771,955658,common_voice_en_30174134.mp3,Taking aim was done by shifting the rear of the carriage.,9,0,male_masculine,9,5400
1772,759975,common_voice_en_16609.mp3,"I thought about whether we should find coins and models in it, and so on.",9,0,male_masculine,9,4800
1773,142465,common_voice_en_33117124.mp3,The pastel colour was chosen because it was easy to repaint.,9,0,male_masculine,9,7416
1774,725576,common_voice_en_48540.mp3,"In spite of this, I still believed that there were men in Mars.",10,1,male_masculine,9,4344
1775,725540,common_voice_en_48503.mp3,Few people realise the immensity of vacancy.,9,0,male_masculine,9,4536
1776,772336,common_voice_en_13308.mp3,Then suddenly he noticed it with a start.,9,0,male_masculine,9,4824
1777,843924,common_voice_en_11980.mp3,"Then suddenly, they kneel and die.",9,0,male_masculine,9,4584
1778,725524,common_voice_en_48486.mp3,We lit the lantern and walked over to his house.,9,0,male_masculine,9,5376
1779,1750244,common_voice_en_38625996.mp3,His other key achievement was the Unification of Karnataka.,9,0,male_masculine,9,5472
1780,725521,common_voice_en_48483.mp3,"Looking through the telescope, I saw a circle of deep blue and the little round planet.",9,0,male_masculine,9,6336
1781,725519,common_voice_en_48481.mp3,But now the sounds inside had stopped.,9,0,male_masculine,9,3024
1782,768813,common_voice_en_35892909.mp3,"To reach uncut forests further west, the company extended the line in stages.",9,0,male_masculine,9,5616
1783,563653,common_voice_en_18006.mp3,He just got a new kite for his birthday.,11,2,male_masculine,9,4104
1784,296254,common_voice_en_20285383.mp3,"He continues to broadcast, while she volunteers to help run a blood drive.",10,1,male_masculine,9,5808
1785,1367620,common_voice_en_32233407.mp3,She is been raised by Osh and their neighbour Miss Magie.,9,0,male_masculine,9,5400
1786,1095415,common_voice_en_32444934.mp3,The best nation is also honoured.,9,0,male_masculine,9,4356
1787,768792,common_voice_en_35892571.mp3,The Potomac River forms the northeast boundary of Colonial Beach.,9,0,male_masculine,9,5436
1788,759979,common_voice_en_16613.mp3,"Why the shots stopped after the tenth, no one on earth has tried to explain.",9,0,male_masculine,9,4944
1789,723421,common_voice_en_82846.mp3,Henderson stood up with a spade in his hand.,9,0,male_masculine,9,4248
1790,174085,common_voice_en_217235.mp3,I'm going to them.,9,0,male_masculine,9,2424
1791,723394,common_voice_en_82819.mp3,But I didn’t think that it contained any living creature.,9,0,male_masculine,9,3744
1792,178824,common_voice_en_31704861.mp3,Lunde has one brother named Barrett.,9,0,male_masculine,9,5256
1793,1095457,common_voice_en_32459902.mp3,Administrative activities of this union are under Char Fashion Police Station.,9,0,male_masculine,9,7020
1794,1095455,common_voice_en_32459900.mp3,It was an unbelievable call.,9,0,male_masculine,9,3420
1795,178563,common_voice_en_38428251.mp3,Connie explodes at Allison for causing rumors.,9,0,male_masculine,9,6048
1796,483169,common_voice_en_15151.mp3,"I don't want to change anything, because I don't know how to deal with change.",10,1,male_masculine,9,5184
1797,725512,common_voice_en_48474.mp3,But I didn’t think that it contained any living creature.,9,0,male_masculine,9,3384
1798,274399,common_voice_en_9570.mp3,"Instead, the stranger lowered it slowly, until the point touched the boy's forehead.",9,0,male_masculine,9,5040
1799,329751,common_voice_en_3505.mp3,He was about the same age and height as the boy.,9,0,male_masculine,9,5232
1800,356510,common_voice_en_30567652.mp3,Aetius directed the operations while Majorian fought with the cavalry.,9,0,male_masculine,9,6336
1801,590621,common_voice_en_32862899.mp3,Defending champion Ivan Lendl withdrew before the tournament due to Davis Cup obligations.,9,0,male_masculine,9,9144
1802,1161981,common_voice_en_36827578.mp3,Local elections are held every four years in the borough.,9,0,male_masculine,9,4140
1803,1095293,common_voice_en_32443001.mp3,The championship teams play at the World Senior Curling Championships the following year.,9,0,male_masculine,9,7740
1804,612396,common_voice_en_32274730.mp3,This was established by students of the Colombo Plan to gain experience.,9,0,male_masculine,9,6732
1805,1285469,common_voice_en_31501812.mp3,He was the father of Harald Scavenius.,9,0,male_masculine,9,4536
1806,1561746,common_voice_en_20627665.mp3,"Once this has been achieved, the lord will hand over his gem.",9,0,male_masculine,9,4440
1807,1285476,common_voice_en_31501819.mp3,He would continue to cultivate this genre until his death.,9,0,male_masculine,9,4968
1808,590610,common_voice_en_32833688.mp3,Slaughter continued to teach high school and college courses throughout his campaign for mayor.,9,0,male_masculine,9,7020
1809,1002646,common_voice_en_35067045.mp3,"Christian had ten extramarital children, for whom he carefully provided.",9,0,male_masculine,9,5940
1810,695880,common_voice_en_32072382.mp3,The performance was considered one of the best from the night.,9,0,male_masculine,9,4068
1811,423287,common_voice_en_36944.mp3,The end of the cylinder was still as Ogilvy and Henderson had left it.,9,0,male_masculine,9,5376
1812,133780,common_voice_en_38754278.mp3,Overman was known for making all-steel bicycles with no cast metal parts.,9,0,male_masculine,9,6912
1813,303130,common_voice_en_32970.mp3,A large portion of the cylinder had been uncovered.,9,0,male_masculine,9,3264
1814,466547,common_voice_en_10492.mp3,He was going to miss the place and all the good things he had learned.,9,0,male_masculine,9,5376
1815,1158021,common_voice_en_44986.mp3,"From the railway station in the distance came the sound of trains, ringing and rumbling.",9,0,male_masculine,9,4464
1816,1285499,common_voice_en_31501847.mp3,She has also worked on axial tilt and precession during interglacial period.,9,0,male_masculine,9,7020
1817,1368072,common_voice_en_32237730.mp3,The Hermitage also houses an oil study for its figure of Pilate.,9,0,male_masculine,9,5328
1818,1002673,common_voice_en_35067178.mp3,Jockey Club Racecourses was formerly called Racecourse Holdings Trust.,9,0,male_masculine,9,6228
1819,768314,common_voice_en_21026.mp3,"So the wind blew with all its strength, and the sky was filled with sand.",9,0,male_masculine,9,5040
1820,1368061,common_voice_en_32237547.mp3,The work lasted all night.,9,0,male_masculine,9,3276
1821,663261,common_voice_en_12849.mp3,You'll be the counselor of the oasis.,9,0,male_masculine,9,3984
1822,663265,common_voice_en_12854.mp3,"One afternoon, one of his servants fell ill, and it appeared that he would die.",9,0,male_masculine,9,6624
1823,1095298,common_voice_en_32443017.mp3,"The events of the story immediately follow those of ""Blind Corner"".",9,0,male_masculine,9,7596
1824,663276,common_voice_en_12865.mp3,It seems old and wise.,10,1,male_masculine,9,2736
1825,381743,common_voice_en_12239.mp3,It brought his heart into his mouth.,10,1,male_masculine,9,2376
1826,1561761,common_voice_en_20627877.mp3,"James T. Hodgson, Junior in command.",9,0,male_masculine,9,3792
1827,1056036,common_voice_en_35198126.mp3,The county seat is Lapeer.,9,0,male_masculine,9,4716
1828,1368169,common_voice_en_32243350.mp3,Adapted from Spotify and Discogs.,9,0,male_masculine,9,4068
1829,1180091,common_voice_en_24275.mp3,He's doing it because it's what he wants to do.,9,0,male_masculine,9,3288
1830,768283,common_voice_en_20995.mp3,"They forgot that lead, copper, and iron have their own destinies to fulfill.",11,2,male_masculine,9,5064
1831,1561222,common_voice_en_20591827.mp3,The development of the system was being accomplished by a team of contractors.,9,0,male_masculine,9,4920
1832,548304,common_voice_en_20627.mp3,We lit the lantern and walked over to his house.,9,0,male_masculine,9,4728
1833,1368159,common_voice_en_32243022.mp3,Each player has four minutes to hit as many home runs as possible.,9,0,male_masculine,9,5616
1834,1561224,common_voice_en_20591830.mp3,It is part of the Hertford and Stortford Parliamentary Constituency.,9,0,male_masculine,9,3960
1835,1180048,common_voice_en_24232.mp3,"The alchemist lighted the fire, and soon a delicious aroma filled the tent.",9,0,male_masculine,9,5352
1836,548311,common_voice_en_20635.mp3,"It is I, the boy answered.",9,0,male_masculine,9,3264
1837,548313,common_voice_en_20637.mp3,"It's almost as if he had been here and left his mark, he thought.",9,0,male_masculine,9,4752
1838,1416080,common_voice_en_37306056.mp3,The expansion included a barque shrine of Amun and a new treasury.,9,0,male_masculine,9,8280
1839,548330,common_voice_en_20655.mp3,He had understood the story the old king had told him.,9,0,male_masculine,9,5448
1840,1180016,common_voice_en_24199.mp3,What is love? the desert asked.,9,0,male_masculine,9,3552
1841,1368139,common_voice_en_32238423.mp3,He decided to replace his birth name with the theonym Baal.,9,0,male_masculine,9,5976
1842,330393,common_voice_en_32689767.mp3,The girl hugged and spoke with Mew every day.,9,0,male_masculine,9,5328
1843,768261,common_voice_en_20973.mp3,They tell their incredible stories at the time when you want to hear them.,9,0,male_masculine,9,4344
1844,1180028,common_voice_en_24211.mp3,"Then the old man began to inspect the sheep, and he saw that one was lame.",10,1,male_masculine,9,5136
1845,172858,common_voice_en_7990.mp3,The boy was relieved.,9,0,male_masculine,9,2736
1846,1415390,common_voice_en_37280781.mp3,Each Pact Boon option produces a special creature or an object.,9,0,male_masculine,9,5940
1847,768266,common_voice_en_20978.mp3,Wait for the end of the war.,9,0,male_masculine,9,2664
1848,411497,common_voice_en_129942.mp3,I wished I had a light to smoke by.,9,0,male_masculine,9,4656
1849,695859,common_voice_en_32068887.mp3,His mother was from Karlsbad.,9,0,male_masculine,9,3996
1850,617651,common_voice_en_636981.mp3,Something inside the cylinder was unscrewing the top.,9,0,male_masculine,9,4104
1851,1180023,common_voice_en_24206.mp3,Then he turned to the boy: this time his expression was cold and distant.,9,0,male_masculine,9,4704
1852,1180022,common_voice_en_24205.mp3,But then he remembered that he wasn't going to have to pay anything.,9,0,male_masculine,9,4224
1853,710049,common_voice_en_17524390.mp3,What became of him?,9,0,male_masculine,9,2016
1854,329743,common_voice_en_3497.mp3,"Half an hour later, his shovel hit something solid.",9,0,male_masculine,9,4632
1855,548331,common_voice_en_20656.mp3,That he had attended a seminary until he was sixteen.,9,0,male_masculine,9,6024
1856,327442,common_voice_en_70555.mp3,I myself heard nothing of that.,9,0,male_masculine,9,5640
1857,409268,common_voice_en_32739133.mp3,Tuve Church is part of the parish.,9,0,male_masculine,9,3636
1858,1032922,common_voice_en_494165.mp3,It spread through the planet's atmosphere and obscured its more familiar features.,9,0,male_masculine,9,4656
1859,844021,common_voice_en_12077.mp3,The shop is exactly the size I always wanted it to be.,9,0,male_masculine,9,5448
1860,272873,common_voice_en_15945.mp3,"At the first glance, it was really not very exciting.",9,0,male_masculine,9,4992
1861,272866,common_voice_en_15938.mp3,"One can imagine these two, covered with sand, running up the little street in the bright sunlight.",9,0,male_masculine,9,6240
1862,1367863,common_voice_en_32236177.mp3,After three weeks of siege Somerset surrendered.,9,0,male_masculine,9,4716
1863,1162033,common_voice_en_37059841.mp3,Both machines could be used in larger multi-machine systems.,9,0,male_masculine,9,4896
1864,843984,common_voice_en_12040.mp3,I used to look at those women and envy them their happiness.,9,0,male_masculine,9,6144
1865,282058,common_voice_en_12898.mp3,"With the wars between the tribes, it's impossible to cross the desert.",10,1,male_masculine,9,8136
1866,654250,common_voice_en_32259525.mp3,The three men were arrested and charged with disorderly conduct.,9,0,male_masculine,9,4968
1867,1561551,common_voice_en_20601468.mp3,I choose to call such a system a mess.,9,0,male_masculine,9,4368
1868,1561514,common_voice_en_20601421.mp3,The sum of all these partial products gives the final result.,9,0,male_masculine,9,3552
1869,768293,common_voice_en_21005.mp3,"A shepherd may like to travel, but he should never forget about his sheep.",10,1,male_masculine,9,5184
1870,355691,common_voice_en_18055.mp3,"I need you to be spontaneous. He asked me out to ""din din.""",9,0,male_masculine,9,4632
1871,340294,common_voice_en_141379.mp3,The time must have been somewhere around six o'clock.,9,0,male_masculine,9,3216
1872,1285556,common_voice_en_31501911.mp3,She worked tirelessly to organize Afrikaner women ecclesiastically and socially.,9,0,male_masculine,9,7668
1873,1285558,common_voice_en_31501913.mp3,The Sisters of the Sacred Heart has established several schools.,9,0,male_masculine,9,6156
1874,375964,common_voice_en_34079.mp3,But the boy couldn't even speak.,9,0,male_masculine,9,3336
1875,700197,common_voice_en_20204.mp3,"Looking through the telescope, I saw a circle of deep blue and the little round planet.",9,0,male_masculine,9,4944
1876,700198,common_voice_en_20205.mp3,Fatima appeared at the entrance to the tent.,9,0,male_masculine,9,2904
1877,355678,common_voice_en_18042.mp3,Ogilvy watched till one and then gave up.,9,0,male_masculine,9,4320
1878,700211,common_voice_en_20218.mp3,"Tomorrow, sell your camel and buy a horse.",9,0,male_masculine,9,3264
1879,164308,common_voice_en_30506506.mp3,The mosque is made of bricks.,9,0,male_masculine,9,3528
1880,1750191,common_voice_en_38579723.mp3,The actual name of the sculpture is The Hiker.,9,0,male_masculine,9,4392
1881,700199,common_voice_en_20206.mp3,All who went there were happy at having done so.,9,0,male_masculine,9,2832
1882,263375,common_voice_en_810.mp3,I heard a peculiar humming sound from the pit.,20,11,male_masculine,9,4608
1883,700216,common_voice_en_20223.mp3,The idea frightened him.,9,0,male_masculine,9,1704
1884,958072,common_voice_en_99427.mp3,He must be disguised to avoid encounters with thieves.,9,0,male_masculine,9,3384
1885,663272,common_voice_en_12861.mp3,There was a moment of silence so profound that it seemed the city was asleep.,9,0,male_masculine,9,7176
1886,663304,common_voice_en_12893.mp3,"He was excited, and at the same time uneasy: maybe the girl had already forgotten him.",10,1,male_masculine,9,7296
1887,1368042,common_voice_en_32237434.mp3,It is one of the museums run by the Fondation Calvet.,9,0,male_masculine,9,7596
1888,663285,common_voice_en_12874.mp3,Only in that way would he be able to read the omens.,9,0,male_masculine,9,4944
1889,1158032,common_voice_en_44997.mp3,And one or two persons were returning.,9,0,male_masculine,9,1944
1890,466540,common_voice_en_10485.mp3,The sword didn't fall.,10,1,male_masculine,9,3216
1891,381759,common_voice_en_12262.mp3,An huge hole had been made by the impact of the projectile.,10,1,male_masculine,9,5376
1892,1158041,common_voice_en_45006.mp3,"When he saw Henderson in his garden, he called over the fence and made himself understood.",10,1,male_masculine,9,5616
1893,1002746,common_voice_en_35067579.mp3,A compressed air ballast system was used for controlling buoyancy.,9,0,male_masculine,9,5328
1894,1002720,common_voice_en_35067393.mp3,A majority of the immigrants were found to be from France and Portugal.,9,0,male_masculine,9,4680
1895,1002722,common_voice_en_35067395.mp3,"Rolle graduated from Blanche Ely High School in Pompano Beach, Florida.",9,0,male_masculine,9,5796
1896,1002759,common_voice_en_35067662.mp3,Each of the doors conceals a prize package of some sort.,9,0,male_masculine,9,3960
1897,1415266,common_voice_en_37280138.mp3,I'm afraid this is going to be a great blow to you.,9,0,male_masculine,9,4536
1898,1367999,common_voice_en_32237261.mp3,An accompanying music video was released alongside the song.,9,0,male_masculine,9,6588
1899,1561606,common_voice_en_20619870.mp3,"Mexico was not the only place from which ""Orizaba"" delivered precious metals.",9,0,male_masculine,9,4584
1900,466537,common_voice_en_10482.mp3,"But he had found a guide, and didn't want to miss out on an opportunity.",9,0,male_masculine,9,6504
1901,1002803,common_voice_en_35068102.mp3,Cross became a well-known literary critic.,9,0,male_masculine,9,3708
1902,1415251,common_voice_en_37279976.mp3,He was carried in a litter through a street which was enclosed by walls.,9,0,male_masculine,9,6480
1903,1158073,common_voice_en_45041.mp3,'m all about those invisible cosmic connections that transcend time and distance.,9,0,male_masculine,9,3456
1904,521177,common_voice_en_208022.mp3,The streamer of gas came out towards us.,9,0,male_masculine,9,3384
1905,1367943,common_voice_en_32237150.mp3,Morningside College continues to list her as an emerita fellow.,9,0,male_masculine,9,6876
1906,1367906,common_voice_en_32236799.mp3,He lived in the eastern part of Kassel.,9,0,male_masculine,9,3636
1907,229261,common_voice_en_34872001.mp3,"Nick Flynn was raised by his mother in Scituate, Massachusetts, a suburb of Boston.",9,0,male_masculine,9,7308
1908,466534,common_voice_en_10479.mp3,The old woman had said the same thing.,9,0,male_masculine,9,3984
1909,90668,common_voice_en_37277736.mp3,"When you reach third level, you can cast the hellish rebuke.",9,0,male_masculine,9,5256
1910,1561669,common_voice_en_20621745.mp3,The school was started at a site not far from the present location.,9,0,male_masculine,9,4728
1911,354564,common_voice_en_32397660.mp3,Much of her work was organized from Market Street in San Francisco.,9,0,male_masculine,9,7020
1912,229256,common_voice_en_34871570.mp3,Other sports like track have also met with success.,9,0,male_masculine,9,4428
1913,204960,common_voice_en_11866.mp3,Wait for the end of the war.,9,0,male_masculine,9,2304
1914,1095337,common_voice_en_32443222.mp3,She was the first female in that role at Oneonta.,9,0,male_masculine,9,5040
1915,1285753,common_voice_en_31502133.mp3,He later served as the inaugural president of the Colored State Press Association.,9,0,male_masculine,9,6696
1916,1398450,common_voice_en_58427.mp3,"We know that, and we are used to it.",9,0,male_masculine,9,2952
1917,1415979,common_voice_en_37289994.mp3,"And besides, how could anyone escape from these rooms?",9,0,male_masculine,9,5436
1918,1285860,common_voice_en_31642421.mp3,Abdullah ruled the emirate from Riyadh.,9,0,male_masculine,9,4860
1919,965608,common_voice_en_18370118.mp3,What did he grow?,9,0,male_masculine,9,2352
1920,259563,common_voice_en_20285974.mp3,"Though operated by Sunoco, the majority of the locations continue to sell Exxon fuels.",10,1,male_masculine,9,9120
1921,652132,common_voice_en_34852.mp3,But none of that mattered to the alchemist.,9,0,male_masculine,9,3144
1922,1398388,common_voice_en_58364.mp3,"When he emerged, it was with a young Arab, dressed in white and gold.",9,0,male_masculine,9,3888
1923,697666,common_voice_en_23594.mp3,The two men hurried back and found the cylinder still lying in the same position.,9,0,male_masculine,9,4536
1924,697665,common_voice_en_23593.mp3,It was only when I got this close to it that the strangeness of it was at all evident to me.,9,0,male_masculine,9,6744
1925,577336,common_voice_en_42021.mp3,"You don't have to be rich, skinny, popular, or even own a cape to perform a random act of kindness.",9,0,male_masculine,9,8952
1926,264135,common_voice_en_36499085.mp3,"Software which became an orphaned work is usually known as ""abandonware"".",9,0,male_masculine,9,6300
1927,922711,common_voice_en_271.mp3,"Wrapped in a scarf and blinded by the blizzard, the boy scrambled for the subway.",10,1,male_masculine,9,7416
1928,298560,common_voice_en_20284817.mp3,"Each meeting room has its own dedicated sound, lighting and networking capabilities.",9,0,male_masculine,9,5496
1929,358146,common_voice_en_30191361.mp3,Alfaro has represented Costa Rica at different age level tournaments.,9,0,male_masculine,9,5328
1930,492696,common_voice_en_46146.mp3,It seemed to him that it fell to earth about one hundred miles east of here.,9,0,male_masculine,9,5616
1931,1562302,common_voice_en_20675193.mp3,Lanza formed a new cabinet in which he was himself minister of the interior.,9,0,male_masculine,9,4920
1932,1285735,common_voice_en_31502104.mp3,He makes his points forcefully.,9,0,male_masculine,9,3708
1933,651286,common_voice_en_68609.mp3,The crowd swayed a little as I elbowed my way through.,9,0,male_masculine,9,3504
1934,577329,common_voice_en_42013.mp3,Now I will drift gently off to dreamland.,9,0,male_masculine,9,3768
1935,453437,common_voice_en_10642.mp3,I'm trying to explain to my mother how to get pictures off her phone.,10,1,male_masculine,9,3888
1936,1562918,common_voice_en_20755920.mp3,Executables can be obtained from the system website.,9,0,male_masculine,9,3624
1937,1044787,common_voice_en_19037.mp3,What good is money to you if you're going to die?,9,0,male_masculine,9,3504
1938,651273,common_voice_en_68596.mp3,It's extremely suspicious that there's no information about brains that didn't come from a brain.,9,0,male_masculine,9,6672
1939,492679,common_voice_en_46129.mp3,I was disappointed at this inanimate bulk.,9,0,male_masculine,9,3720
1940,1398764,common_voice_en_58750.mp3,"It's a dream in the language of the world, she said.",9,0,male_masculine,9,3192
1941,1398668,common_voice_en_58650.mp3,But bakers are more important people than shepherds.,9,0,male_masculine,9,3096
1942,491885,common_voice_en_36718.mp3,The top of the cylinder was rotating on its body.,9,0,male_masculine,9,3120
1943,1415917,common_voice_en_37289821.mp3,Her sister is Kate Hennessy.,9,0,male_masculine,9,3276
1944,453452,common_voice_en_10662.mp3,A thin circle of bright metal showed between the top and the body of the cylinder.,10,1,male_masculine,9,4224
1945,1285738,common_voice_en_31502107.mp3,This settlement has since been abandoned.,9,0,male_masculine,9,4248
1946,1044655,common_voice_en_18901.mp3,"I have had the same dream twice, he said.",9,0,male_masculine,9,3456
1947,1044654,common_voice_en_18900.mp3,He was planning as he left the bar.,9,0,male_masculine,9,2664
1948,776409,common_voice_en_13592.mp3,"Before the boy could reply, a butterfly appeared and fluttered between him and the old man.",9,0,male_masculine,9,8016
1949,358147,common_voice_en_30191363.mp3,Tax evasion and terrorist financing have also been claimed.,9,0,male_masculine,9,5148
1950,306439,common_voice_en_16154.mp3,It must have fallen while I was sitting over there.,9,0,male_masculine,9,4248
1951,1044648,common_voice_en_18894.mp3,The meeting was over.,9,0,male_masculine,9,2184
1952,697287,common_voice_en_17780897.mp3,What does he look like?,9,0,male_masculine,9,2064
1953,1415825,common_voice_en_37289643.mp3,Non-fossil sources of carbon dioxide include fermentation plants and sewage treatment plants.,9,0,male_masculine,9,7668
1954,1161903,common_voice_en_36518045.mp3,Not all trains stop at Torre.,9,0,male_masculine,9,4428
1955,872493,common_voice_en_32193746.mp3,"No further references to certificates by Petherick appear in ""The Strad"".",9,0,male_masculine,9,6228
1956,872491,common_voice_en_32193703.mp3,A Vietnamese child was also killed.,9,0,male_masculine,9,3780
1957,859147,common_voice_en_16308.mp3,He just got a new kite for his birthday.,9,0,male_masculine,9,2880
1958,1285765,common_voice_en_31502151.mp3,She then began her own laboratory at Yale University as an assistant professor.,9,0,male_masculine,9,6876
1959,1285822,common_voice_en_31642267.mp3,The contract allowed him to play professionally while retaining his college soccer eligibility.,9,0,male_masculine,9,7956
1960,1044666,common_voice_en_18913.mp3,All that time the Martians must have been getting ready.,9,0,male_masculine,9,3504
1961,469382,common_voice_en_32870453.mp3,Perry was born in El Paso and subsequently moved to Dallas at age nine.,9,0,male_masculine,9,6516
1962,611397,common_voice_en_488869.mp3,Hundreds of observers saw the flame that night and the night after.,9,0,male_masculine,9,7176
1963,306443,common_voice_en_16158.mp3,That sobered him a little.,10,1,male_masculine,9,2616
1964,679191,common_voice_en_78995.mp3,And he wasn't faring much better.,9,0,male_masculine,9,2544
1965,776467,common_voice_en_13651.mp3,Can I get a woot woot!?,9,0,male_masculine,9,2616
1966,217643,common_voice_en_17389855.mp3,Do you like contemporary paintings?,10,1,male_masculine,9,3576
1967,760775,common_voice_en_620760.mp3,"My wife pointed out to me the brightness of the red, green, and yellow signal lights.",9,0,male_masculine,9,6624
1968,819826,common_voice_en_32914572.mp3,Musician Guylaine Tanguay is acting as the spokesperson of the organization.,9,0,male_masculine,9,6768
1969,1562845,common_voice_en_20746151.mp3,"Instead, he grew heavily invested in television, cartoons, and comic books.",9,0,male_masculine,9,4704
1970,1044768,common_voice_en_19018.mp3,But maybe people who felt that way had never learned the universal language.,9,0,male_masculine,9,4824
1971,1398937,common_voice_en_58927.mp3,"Not to worry, said the alchemist.",9,0,male_masculine,9,2136
1972,819832,common_voice_en_33438998.mp3,The regiment participated in Operation Bluestar soon after its formation.,9,0,male_masculine,9,6372
1973,1044770,common_voice_en_19020.mp3,"Two years ago, right here on this spot, I had a recurrent dream, too.",9,0,male_masculine,9,5976
1974,492685,common_voice_en_46135.mp3,It must have fallen while I was sitting over there.,9,0,male_masculine,9,3144
1975,491862,common_voice_en_36695.mp3,It had a diameter of about thirty yards.,9,0,male_masculine,9,3840
1976,633705,common_voice_en_30419212.mp3,Kierkegaard writes about two individuals who went to the temple.,9,0,male_masculine,9,5508
1977,453200,common_voice_en_45270.mp3,"It was, however, still so hot from its flight through the air.",9,0,male_masculine,9,5568
1978,697626,common_voice_en_23552.mp3,A large portion of the cylinder had been uncovered.,10,1,male_masculine,9,3192
1979,195196,common_voice_en_55363.mp3,Everyone seemed very excited.,9,0,male_masculine,9,3024
1980,922802,common_voice_en_366.mp3,It's lucky you got away from her.,9,0,male_masculine,9,3144
1981,470726,common_voice_en_186195.mp3,I thought the unscrewing might be automatic.,9,0,male_masculine,9,3624
1982,1562507,common_voice_en_20693854.mp3,"Levin is the founding editor of ""National Affairs"".",9,0,male_masculine,9,3888
1983,713303,common_voice_en_32987417.mp3,This was the biggest witch trial in Protestant Geneva.,9,0,male_masculine,9,4716
1984,1145715,common_voice_en_30645531.mp3,The team is owned by Republic Biscuit Corporation.,9,0,male_masculine,9,4068
1985,859067,common_voice_en_16228.mp3,"Sadly, my dream of becoming a squirrel whisperer may never happen.",9,0,male_masculine,9,4272
1986,1562454,common_voice_en_20693003.mp3,Both lines are now part of the Norfolk Southern Railway.,9,0,male_masculine,9,3840
1987,697634,common_voice_en_23561.mp3,"They looked for the fallen mass, but found nothing.",10,1,male_masculine,9,4536
1988,1562147,common_voice_en_20662985.mp3,Note that the solution changes rapidly near the origin.,9,0,male_masculine,9,3600
1989,859052,common_voice_en_16213.mp3,The top had certainly ceased to rotate.,9,0,male_masculine,9,3240
1990,322002,common_voice_en_30232725.mp3,Failure would mean automatic eviction.,9,0,male_masculine,9,4356
1991,1145722,common_voice_en_30645538.mp3,He also designed and planted the perimeter gardens.,9,0,male_masculine,9,3636
1992,1145647,common_voice_en_30645447.mp3,Commonly this type of tubes are used in radio and television receiver.,9,0,male_masculine,9,6084
1993,713313,common_voice_en_32987475.mp3,Some recordings were remakes of originals recorded by other artists.,9,0,male_masculine,9,5076
1994,1416239,common_voice_en_37306391.mp3,The device ceases to function after twenty-four hours.,9,0,male_masculine,9,4356
1995,1044804,common_voice_en_19054.mp3,"All they ever do, really, is look for food and water.",9,0,male_masculine,9,4344
1996,65123,common_voice_en_32066791.mp3,He played as defender or as midfielder.,9,0,male_masculine,9,7020
1997,1416045,common_voice_en_37305991.mp3,The treatment given to individual stories varies widely.,9,0,male_masculine,9,6300
1998,859089,common_voice_en_16250.mp3,"They looked for the fallen mass, but found nothing.",9,0,male_masculine,9,4224
1999,1415828,common_voice_en_37289648.mp3,"It traverses the Mandi District and enters the Kangra District at Sandhol, above sea-level.",9,0,male_masculine,9,7380
2000,1398575,common_voice_en_58555.mp3,It seemed so safe and tranquil.,9,0,male_masculine,9,2064
2001,456723,common_voice_en_31590.mp3,It seemed so safe and tranquil.,10,1,male_masculine,9,2784
2002,456720,common_voice_en_31586.mp3,Ogilvy told him everything that he had seen.,9,0,male_masculine,9,5112
2003,569730,common_voice_en_18069082.mp3,"First come, first served.",9,0,male_masculine,9,2736
2004,512593,common_voice_en_95068.mp3,Absolutely despicable that gingerbread men are forced to live in houses made of their own flesh.,9,0,male_masculine,9,8184
2005,1145738,common_voice_en_30645556.mp3,Manchester and London.,9,0,male_masculine,9,3024
2006,336800,common_voice_en_31824.mp3,What he said reminded the boy of the old king.,9,0,male_masculine,9,3384
2007,470523,common_voice_en_64080.mp3,A thin circle of bright metal showed between the top and the body of the cylinder.,9,0,male_masculine,9,4752
2008,1044822,common_voice_en_19072.mp3,"And so, despite the fact that he was a Roman centurion, he converted to their faith.",9,0,male_masculine,9,5544
2009,1145826,common_voice_en_30650413.mp3,He also appeared in few character roles during this time.,9,0,male_masculine,9,4248
2010,197481,common_voice_en_17319.mp3,Only the lights in the great tent remained.,10,1,male_masculine,9,4056
2011,197483,common_voice_en_17322.mp3,"He fell asleep, and when he awoke the sun was already high.",9,0,male_masculine,9,5184
2012,859114,common_voice_en_16275.mp3,It must have fallen while I was sitting over there.,9,0,male_masculine,9,3648
2013,633671,common_voice_en_30412443.mp3,Al Ahly are the defending champions having defeated Kaizer Chiefs on finals.,9,0,male_masculine,9,6660
2014,1562987,common_voice_en_20776380.mp3,He is the Chairman of the East Asian Institute.,9,0,male_masculine,9,3192
2015,651258,common_voice_en_68581.mp3,Some of the grey ash was falling off the circular edge.,9,0,male_masculine,9,5304
2016,859055,common_voice_en_16216.mp3,What had been next to him five minutes ago was now at the other side.,10,1,male_masculine,9,4536
2017,1562352,common_voice_en_20677268.mp3,The township contains Saint Johns Cemetery.,9,0,male_masculine,9,4416
2018,1145805,common_voice_en_30650392.mp3,That same year the club disaffiliated and never returned to official competitions.,9,0,male_masculine,9,7416
2019,859057,common_voice_en_16218.mp3,"It was starlight, and I explained the Signs of the Zodiac to her.",9,0,male_masculine,9,4872
2020,859058,common_voice_en_16219.mp3,I had seen all that it would presently bring me.,9,0,male_masculine,9,3792
2021,1563215,common_voice_en_20872568.mp3,There are two different versions of the music video.,9,0,male_masculine,9,3696
2022,1285728,common_voice_en_31502097.mp3,The channel is an important migration corridor for juvenile sockeye salmon.,9,0,male_masculine,9,7740
2023,859135,common_voice_en_16296.mp3,That sobered him a little.,9,0,male_masculine,9,2856
2024,859107,common_voice_en_16268.mp3,Some of those who saw its flight say it travelled with a hissing sound.,10,1,male_masculine,9,4152
2025,500498,common_voice_en_38596.mp3,"In spite of this, I still believed that there were men in Mars.",9,0,male_masculine,9,4440
2026,859099,common_voice_en_16260.mp3,The first rule of don't fight club is let's talk about it.,10,1,male_masculine,9,4464
2027,1285850,common_voice_en_31642381.mp3,His district includes West Las Vegas.,9,0,male_masculine,9,4356
2028,859098,common_voice_en_16259.mp3,No doubt the impact had caused a flash of fire.,9,0,male_masculine,9,3264
2029,530491,common_voice_en_7870.mp3,"I came to tell you just one thing, the boy said.",9,0,male_masculine,9,4704
2030,1563129,common_voice_en_20820111.mp3,"The journal's charts were used by ""Rolling Stone"" magazine and other media.",9,0,male_masculine,9,3816
2031,530481,common_voice_en_7859.mp3,"That's right, said the old man, able to read the boy's thoughts.",9,0,male_masculine,9,4920
2032,530484,common_voice_en_7862.mp3,He brought six sheep with him.,11,2,male_masculine,9,3480
2033,859083,common_voice_en_16244.mp3,"I pointed out Mars, a bright dot of light.",10,1,male_masculine,9,3888
2034,859082,common_voice_en_16243.mp3,They shouted consolation and promises and went off back to the town again to get help.,9,0,male_masculine,9,5184
2035,1347788,common_voice_en_147509.mp3,The crowd swayed a little as I elbowed my way through.,9,0,male_masculine,9,3888
2036,859080,common_voice_en_16241.mp3,I found a little crowd of about twenty people surrounding the huge hole.,10,1,male_masculine,9,4704
2037,859110,common_voice_en_16271.mp3,He noticed the unequal cooling of its surface.,11,2,male_masculine,9,3432
2038,859077,common_voice_en_16238.mp3,It had a diameter of about thirty yards.,10,1,male_masculine,9,2784
2039,859109,common_voice_en_16270.mp3,Ogilvy told him everything that he had seen.,9,0,male_masculine,9,2928
2040,713271,common_voice_en_32987178.mp3,The nearest secondary school is Mirani State High School in Mirani.,9,0,male_masculine,9,4500
2041,1145943,common_voice_en_35209771.mp3,David Gedge's songwriting chronicles relationships breaking up or never taking off.,9,0,male_masculine,9,5184
2042,697642,common_voice_en_23569.mp3,It left a greenish streak that glowed for some seconds.,11,2,male_masculine,9,3864
2043,503403,common_voice_en_12994.mp3,What kind of blow should one deliver next in order to remain alive?,9,0,male_masculine,9,4776
2044,1398940,common_voice_en_58930.mp3,I should have repeated it for him.,9,0,male_masculine,9,2544
2045,742483,common_voice_en_30702906.mp3,Rauh also played the German premieres of several compositions by contemporary composers.,9,0,male_masculine,9,6660
2046,1398743,common_voice_en_58729.mp3,The boy said nothing.,9,0,male_masculine,9,1584
2047,917838,common_voice_en_17726461.mp3,"We have already met, but it would be nice to see him again.",9,0,male_masculine,9,5328
2048,820416,common_voice_en_109572.mp3,"There were really, I think, two or three hundred people elbowing one another.",9,0,male_masculine,9,4824
2049,922701,common_voice_en_261.mp3,When can I see him?,9,0,male_masculine,9,2496
2050,1562219,common_voice_en_20673610.mp3,Simes and Gens have traditionally lived in separate territories.,9,0,male_masculine,9,3936
2051,768253,common_voice_en_20965.mp3,The Soul of the World is nourished by people's happiness.,11,2,male_masculine,9,3648
2052,1180286,common_voice_en_24474.mp3,"All they ever do, really, is look for food and water.",10,1,male_masculine,9,4272
2053,1416071,common_voice_en_37306032.mp3,The trend is for two-tier states to gradually move towards a one-tier system.,9,0,male_masculine,9,6228
2054,1044693,common_voice_en_18942.mp3,"Before long, maybe in just a few days, he would be at the Pyramids.",9,0,male_masculine,9,5016
2055,501275,common_voice_en_85945.mp3,A line of flame high can be seen in the atmosphere.,9,0,male_masculine,9,6264
2056,1044699,common_voice_en_18948.mp3,Replace the Ts in Tim Tebow's name with any other consonant to get a Star Wars character,9,0,male_masculine,9,6384
2057,1562692,common_voice_en_20714742.mp3,The series was produced by Colin Gilbert and the script editor was Philip Differ.,9,0,male_masculine,9,5208
2058,503393,common_voice_en_12984.mp3,"Before the boy could reply, a butterfly appeared and fluttered between him and the old man.",9,0,male_masculine,9,5952
2059,1044745,common_voice_en_18995.mp3,"Since the miner had sacrificed everything to his destiny, the old man decided to become involved.",9,0,male_masculine,9,6816
2060,1416004,common_voice_en_37290133.mp3,Slowe produced etchings.,9,0,male_masculine,9,4968
2061,768254,common_voice_en_20966.mp3,"Later, we simply let life proceed, in its own direction, toward its own fate.",9,0,male_masculine,9,6024
2062,1562071,common_voice_en_20651398.mp3,His doctoral thesis concerned the measurement of anaerobic threshold in the sport of running.,9,0,male_masculine,9,5640
2063,1180278,common_voice_en_24466.mp3,I've had this shop for thirty years.,9,0,male_masculine,9,2544
2064,1415807,common_voice_en_37289503.mp3,This title also grants him and his family Legal immunity.,9,0,male_masculine,9,6300
2065,486192,common_voice_en_20284746.mp3,Drumare himself had high praise for the problem.,12,3,male_masculine,9,4992
2066,1044719,common_voice_en_18968.mp3,"As he was leaving, he saw, in the corner of the room, his old shepherd's pouch.",9,0,male_masculine,9,6456
2067,872435,common_voice_en_32188496.mp3,He married Ellen Gudgeon.,9,0,male_masculine,9,3420
2068,429164,common_voice_en_17796085.mp3,"Java is not only an island, but also a popular programming language.",9,0,male_masculine,9,4872
2069,429151,common_voice_en_66428.mp3,Hundreds of observers saw the flame that night and the night after.,9,0,male_masculine,9,5496
2070,1416030,common_voice_en_37305967.mp3,Some of my readers perhaps doubt whether this really made the men bombproof.,9,0,male_masculine,9,7848
2071,1285756,common_voice_en_31502137.mp3,Several dictionaries that used this spelling were published without permission.,9,0,male_masculine,9,5256
2072,503402,common_voice_en_12993.mp3,The boy thought of Fatima.,10,1,male_masculine,9,2880
2073,1161895,common_voice_en_36518025.mp3,A wedge can also be classified as a digonal cupola.,9,0,male_masculine,9,4932
2074,1180253,common_voice_en_24441.mp3,And ask for a glass of wine for me.,9,0,male_masculine,9,2712
2075,1044718,common_voice_en_18967.mp3,"The camel driver was seated at the base of a palm tree, observing the sunset.",9,0,male_masculine,9,5664
2076,1561859,common_voice_en_20644223.mp3,It is the weakest base among the alkali metal hydroxides.,9,0,male_masculine,9,4584
2077,469348,common_voice_en_75965.mp3,Hires two personal trainers and make one of them train the other one.,9,0,male_masculine,9,5328
2078,872505,common_voice_en_32193786.mp3,They are arranged in irregular groups.,9,0,male_masculine,9,3096
2079,820389,common_voice_en_109544.mp3,It brought his heart into his mouth.,9,0,male_masculine,9,2808
2080,1278430,common_voice_en_20285761.mp3,The label represents performers who have contributed to and have marked Quebec's cultural scene.,9,0,male_masculine,9,7632
2081,453084,common_voice_en_45198.mp3,They set off running wildly into the trees.,9,0,male_masculine,9,2280
2082,1416207,common_voice_en_37306321.mp3,"They had children Jody, Billy and Molly.",9,0,male_masculine,9,5688
2083,503399,common_voice_en_12990.mp3,"Then he realized that he had been distracted for a few moments, looking at the sword.",11,2,male_masculine,9,4368
2084,429135,common_voice_en_66412.mp3,"Revenge is not my style, but obviously accidents will happen.",9,0,male_masculine,9,5184
2085,1285726,common_voice_en_31502095.mp3,The fleet withdrew that same evening to Crete and from there to Italy.,9,0,male_masculine,9,6588
2086,503408,common_voice_en_12999.mp3,"Even from a distance, their eyes conveyed the strength of their souls.",9,0,male_masculine,9,5352
2087,776431,common_voice_en_13614.mp3,But the boy was quiet.,10,1,male_masculine,9,2616
2088,776433,common_voice_en_13616.mp3,It's not I the wind spoke about.,9,0,male_masculine,9,4584
2089,776404,common_voice_en_13587.mp3,There was no way for everybody to know about alchemy.,9,0,male_masculine,9,4296
2090,1180314,common_voice_en_24503.mp3,What's your name? he asked.,10,1,male_masculine,9,2664
2091,343010,common_voice_en_32649918.mp3,"The following year he became European Champion with his team ""Sage Supercilia"".",9,0,male_masculine,9,6948
2092,1095435,common_voice_en_32445181.mp3,The marriage was forced upon her against her will and was reportedly unhappy.,9,0,male_masculine,9,7056
2093,429142,common_voice_en_66419.mp3,He noticed the unequal cooling of its surface.,9,0,male_masculine,9,4344
2094,1416022,common_voice_en_37290209.mp3,"In both Hebrew and Aramaic the word could also mean ""shame, disgrace"".",9,0,male_masculine,9,8748
2095,1145944,common_voice_en_35209777.mp3,The club's feeder league is the Port Moresby Rugby League competition.,9,0,male_masculine,9,4608
2096,1562750,common_voice_en_20725266.mp3,Hornaday later criticized Foyt for dismissing him so late in the season.,9,0,male_masculine,9,4248
2097,1563504,common_voice_en_20912685.mp3,"When Nearchus leaned in to listen to the secret, Zeno bit his ear.",9,0,male_masculine,9,4464
2098,768255,common_voice_en_20967.mp3,"The horizon was tinged with red, and suddenly the sun appeared.",10,1,male_masculine,9,4896
2099,1562880,common_voice_en_20748392.mp3,"However, most of the Lee Metcalf lies in neighboring Gallatin National Forest.",9,0,male_masculine,9,6000
2100,1044763,common_voice_en_19013.mp3,"I don't understand what you're talking about, the desert said.",9,0,male_masculine,9,4056
2101,503387,common_voice_en_12978.mp3,The sheep had taught him that.,10,1,male_masculine,9,2592
2102,1044727,common_voice_en_18976.mp3,"Your eyes show the strength of your soul, answered the alchemist.",9,0,male_masculine,9,4344
2103,922724,common_voice_en_285.mp3,But you've got to leave me alone.,8,0,male_masculine,8,2568
2104,1182177,common_voice_en_30531326.mp3,Three athletes won multiple individual titles.,8,0,male_masculine,8,4716
2105,628152,common_voice_en_11803.mp3,The Englishman didn't answer him directly.,9,1,male_masculine,8,7488
2106,922725,common_voice_en_286.mp3,Thank you very much.,8,0,male_masculine,8,2784
2107,801190,common_voice_en_17226.mp3,He heard a muffled grating sound and saw the black mark jerk forward an inch or so.,8,0,male_masculine,8,5496
2108,281962,common_voice_en_33932697.mp3,It is the easternmost point of Wrangel Island.,8,0,male_masculine,8,4176
2109,796147,common_voice_en_31063535.mp3,After graduation she worked at the Mater Hospital Child Guidance Clinic.,8,0,male_masculine,8,5652
2110,1182369,common_voice_en_30531963.mp3,Duarte is listed at and and bats and throws right handed.,8,0,male_masculine,8,7056
2111,375961,common_voice_en_34076.mp3,"The boy began again to read his book, but he was no longer able to concentrate.",9,1,male_masculine,8,5616
2112,1182134,common_voice_en_30531172.mp3,The reduced suspension was due to his fight being taken on short notice.,8,0,male_masculine,8,6228
2113,497579,common_voice_en_487638.mp3,I'm going to them.,8,0,male_masculine,8,2016
2114,796146,common_voice_en_31063524.mp3,The mountain is best known for its hiking trail that goes to the summit.,8,0,male_masculine,8,4932
2115,1182138,common_voice_en_30531181.mp3,She specialised in ancient irrigation systems and African drylands.,8,0,male_masculine,8,6480
2116,1430540,common_voice_en_38156112.mp3,He says we jostle at the same trough.,8,0,male_masculine,8,3348
2117,272967,common_voice_en_97179.mp3,The two men hurried back and found the cylinder still lying in the same position.,8,0,male_masculine,8,6120
2118,1182136,common_voice_en_30531174.mp3,The chest in the Tibetan monastery was destroyed when the apocalypse struck.,8,0,male_masculine,8,5940
2119,796145,common_voice_en_31063523.mp3,"The species epithet ""axillaris"" refers to the stripes on the sides of the body.",8,0,male_masculine,8,6336
2120,82952,common_voice_en_31830534.mp3,The type was collected by Kauffman at Lake Quinault in Washington.,8,0,male_masculine,8,5760
2121,769911,common_voice_en_39579052.mp3,The station buildings themselves were not significantly altered as they are heritage listed.,8,0,male_masculine,8,5652
2122,82953,common_voice_en_31830535.mp3,The Germans stayed for four days.,8,0,male_masculine,8,4428
2123,796134,common_voice_en_31063471.mp3,His best known student there was Anton Burger.,8,0,male_masculine,8,4032
2124,796165,common_voice_en_31063626.mp3,His father who had stayed behind was later killed.,8,0,male_masculine,8,4212
2125,801180,common_voice_en_17216.mp3,"But you will love her, and she'll return your love.",9,1,male_masculine,8,5616
2126,697632,common_voice_en_23558.mp3,The night was warm and I was thirsty.,9,1,male_masculine,8,2280
2127,796162,common_voice_en_31063603.mp3,King lived and worked in Portland for the rest of his life.,8,0,male_masculine,8,4608
2128,796202,common_voice_en_31098568.mp3,"Bill Kunkel reviewed the game for ""Electronic Games"" and was not impressed.",8,0,male_masculine,8,5436
2129,1182146,common_voice_en_30531194.mp3,He also served at five other overseas diplomatic posts.,8,0,male_masculine,8,6048
2130,1182173,common_voice_en_30531307.mp3,The winners represent Armagh in the Ulster Senior Club Football Championship.,8,0,male_masculine,8,6300
2131,1182174,common_voice_en_30531323.mp3,The teams that lose their first round advance to the second round.,8,0,male_masculine,8,6948
2132,1818131,common_voice_en_26634594.mp3,It is located in the borough of Lund in the district of Gimlekollen.,10,2,male_masculine,8,8028
2133,1182145,common_voice_en_30531193.mp3,The plan involved no changes to John Curtin College of the Arts.,8,0,male_masculine,8,5328
2134,1182133,common_voice_en_30531171.mp3,He would retained the position after the council was dissolved.,8,0,male_masculine,8,5940
2135,796161,common_voice_en_31063602.mp3,He undertook repairs and refurbishment.,8,0,male_masculine,8,3492
2136,1047195,common_voice_en_37647998.mp3,She worked behind the scenes on news programs there.,8,0,male_masculine,8,4176
2137,1182143,common_voice_en_30531191.mp3,He was the founder and executive director of Black Voices for Peace.,8,0,male_masculine,8,5976
2138,390239,common_voice_en_60607.mp3,Your money saved us for three days.,8,0,male_masculine,8,3528
2139,1182141,common_voice_en_30531184.mp3,She has held many writing workshops for children within Egypt and other countries.,8,0,male_masculine,8,7236
2140,404476,common_voice_en_153105.mp3,No doubt the impact had caused a flash of fire.,8,0,male_masculine,8,2976
2141,1182140,common_voice_en_30531183.mp3,He was interred at Oakwood Cemetery in Austin.,8,0,male_masculine,8,5148
2142,796149,common_voice_en_31063537.mp3,Many ecological studies have been conducted at the prairie by college faculty and others.,8,0,male_masculine,8,5904
2143,281960,common_voice_en_33932657.mp3,Hutton Mills was the secretary.,8,0,male_masculine,8,3168
2144,801184,common_voice_en_17220.mp3,"They're only made of rock crystal, and there are millions of rock crystals in the earth.",8,0,male_masculine,8,5736
2145,281961,common_voice_en_33932677.mp3,Some of the militants flew from the place in sensing defeat.,8,0,male_masculine,8,5184
2146,1072970,common_voice_en_38064137.mp3,Germany has a Federal Returning Officer and a returning officer in each State.,8,0,male_masculine,8,6840
2147,796148,common_voice_en_31063536.mp3,The museum has increasingly specialized in modern and contemporary art.,8,0,male_masculine,8,5256
2148,1182370,common_voice_en_30531964.mp3,Her actions inspired the defending troops and the French forces were repulsed.,8,0,male_masculine,8,6768
2149,82954,common_voice_en_31830536.mp3,Gross.,8,0,male_masculine,8,2628
2150,796204,common_voice_en_31098587.mp3,That year she moved from the University of Southampton to the University of Birmingham.,8,0,male_masculine,8,6552
2151,470517,common_voice_en_64074.mp3,It left a greenish streak that glowed for some seconds.,8,0,male_masculine,8,4152
2152,1707271,common_voice_en_38571381.mp3,She was most famous for writing adventure stories and fantasies.,8,0,male_masculine,8,5868
2153,1413606,common_voice_en_30151331.mp3,Treatments for the majority of these diseases exist only as palliative care.,8,0,male_masculine,8,5040
2154,1182382,common_voice_en_30531977.mp3,A navigation station is fitted to starboard.,8,0,male_masculine,8,5688
2155,318377,common_voice_en_34386698.mp3,The video was directed by Adil Shaikh.,8,0,male_masculine,8,3816
2156,1182181,common_voice_en_30531335.mp3,The main idol is Lakshmana Perumal.,8,0,male_masculine,8,4356
2157,1044678,common_voice_en_18927.mp3,His eyes filled with tears as he spoke of the Prophet.,8,0,male_masculine,8,3384
2158,1044546,common_voice_en_18242183.mp3,That is very interesting.,8,0,male_masculine,8,3216
2159,1182180,common_voice_en_30531334.mp3,It is usually celebrated in the month of July.,8,0,male_masculine,8,4680
2160,1182179,common_voice_en_30531333.mp3,His many possessions were subject to different inheritance laws.,8,0,male_masculine,8,5256
2161,470826,common_voice_en_43128.mp3,And he wasn't faring much better.,10,2,male_masculine,8,1944
2162,1182118,common_voice_en_30531142.mp3,It also means that queries should be fast and finish at interactive speeds.,8,0,male_masculine,8,6408
2163,1198113,common_voice_en_30614359.mp3,She confesses and accepts him.,8,0,male_masculine,8,3492
2164,281964,common_voice_en_33932712.mp3,Fragile grassland ecosystems in Sichuan have suffered for decades.,8,0,male_masculine,8,7092
2165,900938,common_voice_en_33402253.mp3,Quran also contains the flood narrative.,8,0,male_masculine,8,3276
2166,1182119,common_voice_en_30531143.mp3,Bolt then was hired as the head coach of Texarkana College.,8,0,male_masculine,8,6120
2167,1455303,common_voice_en_35193327.mp3,India were the Gold medalists.,8,0,male_masculine,8,3168
2168,281965,common_voice_en_33932720.mp3,List of Wisconsin rivers,8,0,male_masculine,8,2736
2169,1182113,common_voice_en_30531137.mp3,"The recipient of the Lifetime Achievement Award is decided by the ""Billboard"" editorial committee.",8,0,male_masculine,8,7236
2170,1824965,common_voice_en_32234535.mp3,She is affiliated to the National Resistance Movement.,8,0,male_masculine,8,5688
2171,796207,common_voice_en_31098591.mp3,Houston worked as secretary to Howard music educator Lulu Vere Childers.,8,0,male_masculine,8,5940
2172,1363164,common_voice_en_36499332.mp3,A parent will resent it if you say that the baby is like them.,8,0,male_masculine,8,5616
2173,1833298,common_voice_en_38371397.mp3,"Aside from her time in Vaudeville, Trudy taught swimming to deaf children.",8,0,male_masculine,8,7236
2174,796206,common_voice_en_31098589.mp3,The massif is one of the last wilderness areas in southern Quebec.,12,4,male_masculine,8,5256
2175,796205,common_voice_en_31098588.mp3,Ask that lady to lift up her head!,8,0,male_masculine,8,3024
2176,470515,common_voice_en_64072.mp3,"About eleven, I walked back to my home in Maybury because nothing seemed to be happening.",10,2,male_masculine,8,5088
2177,470510,common_voice_en_64067.mp3,The end of the cylinder was still as Ogilvy and Henderson had left it.,8,0,male_masculine,8,4944
2178,1182114,common_voice_en_30531138.mp3,The southern end of the lake extends into Mongolia.,8,0,male_masculine,8,5076
2179,1182115,common_voice_en_30531139.mp3,Polis was not involved in their rematch.,8,0,male_masculine,8,4680
2180,1182182,common_voice_en_30531336.mp3,Crawley were drawn at home to Tranmere Rovers in the first round.,8,0,male_masculine,8,6336
2181,301100,common_voice_en_9793.mp3,I found a little crowd of about twenty people surrounding the huge hole.,10,2,male_masculine,8,5808
2182,1786254,common_voice_en_20723647.mp3,"Hansen disliked the term ""gay"" and always described himself as ""homosexual"".",8,0,male_masculine,8,9720
2183,844004,common_voice_en_12060.mp3,What he said reminded the boy of the old king.,8,0,male_masculine,8,5304
2184,1182116,common_voice_en_30531140.mp3,The books are open and can be updated online.,8,0,male_masculine,8,5580
2185,1182117,common_voice_en_30531141.mp3,The houses in this neighborhood were partly built for artisans and skilled tradespeople.,8,0,male_masculine,8,8280
2186,390228,common_voice_en_60596.mp3,"Those are the rules of war, the leader explained.",8,0,male_masculine,8,3456
2187,535804,common_voice_en_120965.mp3,You point to a trail of ants leading into the house.,8,0,male_masculine,8,4224
2188,1182124,common_voice_en_30531155.mp3,I will go the other way.,8,0,male_masculine,8,3060
2189,377334,common_voice_en_35667.mp3,That doesn't happen to just anyone!,8,0,male_masculine,8,3264
2190,1182381,common_voice_en_30531976.mp3,The former community is part of the Old Barn Resort.,8,0,male_masculine,8,5328
2191,535785,common_voice_en_120946.mp3,A boy came running towards me.,8,0,male_masculine,8,2640
2192,1182125,common_voice_en_30531156.mp3,Both physicians were Zenana medical missionaries who performed amputations and other necessary surgeries.,8,0,male_masculine,8,8820
2193,1182126,common_voice_en_30531157.mp3,The office will focus on the automation of Indian tire factories.,8,0,male_masculine,8,5940
2194,1182127,common_voice_en_30531159.mp3,The bay is exposed to the easterly and northeasterly trade winds.,8,0,male_masculine,8,6228
2195,1182120,common_voice_en_30531144.mp3,Amelot had to return.,8,0,male_masculine,8,2988
2196,1182128,common_voice_en_30531165.mp3,She later dropped the suit.,8,0,male_masculine,8,3600
2197,796133,common_voice_en_31063470.mp3,He spent his last few years travelling widely through Sicily and Yemen.,8,0,male_masculine,8,5328
2198,1182130,common_voice_en_30531167.mp3,She rescued people who had been conned to be come servants in Arabia.,8,0,male_masculine,8,6120
2199,1704480,common_voice_en_37253678.mp3,Antonio has a deep fear of the brothel because it represents sin.,12,4,male_masculine,8,7164
2200,535783,common_voice_en_120944.mp3,"I was scared, but wasted no time in going out and crossing the bridge to the sand pits.",8,0,male_masculine,8,6360
2201,697628,common_voice_en_23554.mp3,It brought his heart into his mouth.,10,2,male_masculine,8,2808
2202,1182131,common_voice_en_30531168.mp3,The lack of coordination with the Madrid authorities was another major problem.,8,0,male_masculine,8,7380
2203,1182132,common_voice_en_30531170.mp3,The committee was headed by the Canadian postal executive Moya Greene.,8,0,male_masculine,8,5508
2204,508892,common_voice_en_9537.mp3,"If I could, I'd write a huge encyclopedia just about the words luck and coincidence.",8,0,male_masculine,8,6744
2205,1821105,common_voice_en_30320628.mp3,He was replaced for the subsequent tour by Larry Montana.,8,0,male_masculine,8,5148
2206,796203,common_voice_en_31098586.mp3,She was accused of having sex with the devil and tortured until she confessed.,8,0,male_masculine,8,5472
2207,1182368,common_voice_en_30531962.mp3,It is the court of last resort.,8,0,male_masculine,8,3780
2208,1182121,common_voice_en_30531145.mp3,The pair sang to each other while maintaining their distance on stage.,8,0,male_masculine,8,6156
2209,801207,common_voice_en_17243.mp3,"They began to ride out over the sands, with the moon lighting their way.",8,0,male_masculine,8,5232
2210,694143,common_voice_en_30677965.mp3,"Wellington Mayor Sir Michael Fowler later described Duff as an ""extremely good"" councillor.",8,0,male_masculine,8,6912
2211,495349,common_voice_en_53195.mp3,"You have helped me. The man continued to prepare his tea, saying nothing.",8,0,male_masculine,8,5544
2212,1044670,common_voice_en_18917.mp3,The treasure is at the Pyramids; that you already knew.,9,1,male_masculine,8,4704
2213,281199,common_voice_en_17789461.mp3,"Regarding your request, I have decided to heed your warnings.",8,0,male_masculine,8,5040
2214,1823163,common_voice_en_31428321.mp3,Natural disasters tend to have unequal impacts on communities of color.,10,2,male_masculine,8,6408
2215,1182122,common_voice_en_30531146.mp3,"Baobab ""(Adansonia digitata)"" is also common.",8,0,male_masculine,8,6048
2216,503412,common_voice_en_13003.mp3,"Your eyes show the strength of your soul, answered the alchemist.",8,0,male_masculine,8,4824
2217,922762,common_voice_en_325.mp3,You're a week late for school already.,8,0,male_masculine,8,3576
2218,281963,common_voice_en_33932698.mp3,He eventually settled on biology.,8,0,male_masculine,8,4032
2219,1182123,common_voice_en_30531147.mp3,He was also an England Youth international.,8,0,male_masculine,8,4680
2220,503411,common_voice_en_13002.mp3,"Yet, it was a little too large for assurance.",8,0,male_masculine,8,4008
2221,1238305,common_voice_en_36735594.mp3,"It is controlled from the deck by halliards, in-hauls and sheets.",10,2,male_masculine,8,3924
2222,486213,common_voice_en_20285313.mp3,The double-click timing delay can usually be configured by the user.,9,1,male_masculine,8,5256
2223,470837,common_voice_en_43139.mp3,"In spite of this, I still believed that there were men in Mars.",9,1,male_masculine,8,3552
2224,535813,common_voice_en_120974.mp3,The time must have been somewhere around six o'clock.,8,0,male_masculine,8,3312
2225,1044652,common_voice_en_18898.mp3,"I am in search of that universal language, among other things.",8,0,male_masculine,8,4536
2226,1833524,common_voice_en_38570403.mp3,Saraland is served by the Saraland Board of Education.,8,0,male_masculine,8,5040
2227,796173,common_voice_en_31063650.mp3,This snail is very rare and only found on the summit of Mount Gower.,8,0,male_masculine,8,5184
2228,1044624,common_voice_en_18870.mp3,"I'll be back, the boy said.",8,0,male_masculine,8,3096
2229,1707135,common_voice_en_38557191.mp3,They are used as mild dehydrating agent.,8,0,male_masculine,8,6012
2230,796175,common_voice_en_31063692.mp3,Gurney narrowly defeated Berry to win his first of two terms in the Senate.,8,0,male_masculine,8,5328
2231,1767280,common_voice_en_18016004.mp3,The weight of the package was seen on the high scale.,8,0,male_masculine,8,3288
2232,796176,common_voice_en_31063693.mp3,This led to classifications of many further families of small order groups.,12,4,male_masculine,8,5184
2233,801158,common_voice_en_17194.mp3,But the merchant understood what the boy had said.,8,0,male_masculine,8,3264
2234,796210,common_voice_en_31098606.mp3,It runs for slightly less than two minutes.,8,0,male_masculine,8,3204
2235,700217,common_voice_en_20224.mp3,He had never even wept in front of his own sheep.,8,0,male_masculine,8,3432
2236,1182376,common_voice_en_30531971.mp3,It also hosts several offices under the Cebu City Government.,8,0,male_masculine,8,5148
2237,700245,common_voice_en_20252.mp3,But children always seem to be able to play with them without frightening them.,8,0,male_masculine,8,4152
2238,1182161,common_voice_en_30531285.mp3,He also studied organ and choral conducting.,8,0,male_masculine,8,5688
2239,796211,common_voice_en_31098607.mp3,Two subspecies were identified.,8,0,male_masculine,8,2844
2240,1182162,common_voice_en_30531286.mp3,The chief productions at the theatre were initially opera.,8,0,male_masculine,8,5040
2241,796213,common_voice_en_31378529.mp3,"The full former line was renamed the ""Barcroft–South Fairlington Line"".",8,0,male_masculine,8,6084
2242,1182375,common_voice_en_30531970.mp3,He replaced Paul Abramson.,8,0,male_masculine,8,4068
2243,796209,common_voice_en_31098605.mp3,The species is endemic to the Solomon Islands.,8,0,male_masculine,8,3852
2244,355685,common_voice_en_18049.mp3,"Had our instruments permitted it, we might have been able to see the trouble way back when.",8,0,male_masculine,8,6384
2245,943434,common_voice_en_32320916.mp3,It was produced by Sriram under Janatha Pictures.,8,0,male_masculine,8,4248
2246,652090,common_voice_en_34808.mp3,"If you start your emails with ""Greetings"" let me be the first to welcome you to Earth.",8,0,male_masculine,8,5976
2247,796168,common_voice_en_31063630.mp3,In the description Cabello dedicated the video to her father.,8,0,male_masculine,8,4644
2248,975024,common_voice_en_18407.mp3,"To understand recursion, one must first learn about recursion.",8,0,male_masculine,8,3936
2249,375965,common_voice_en_34080.mp3,"To show you one of life's simple lessons, the alchemist answered.",8,0,male_masculine,8,4896
2250,1044620,common_voice_en_18866.mp3,"Of course, the two were unable to do anything.",8,0,male_masculine,8,3696
2251,796199,common_voice_en_31098563.mp3,He later moved to Uzbekistan and then to Moscow.,8,0,male_masculine,8,4284
2252,1363231,common_voice_en_37197579.mp3,"He helped redecorate the ""Sala della Niobe"" in the Uffizi Gallery.",8,0,male_masculine,8,6156
2253,796198,common_voice_en_31098561.mp3,A central fireplace heats the first floor.,8,0,male_masculine,8,3636
2254,1044635,common_voice_en_18881.mp3,"It's the oasis, said the camel driver.",8,0,male_masculine,8,3336
2255,796171,common_voice_en_31063648.mp3,It is unknown how many instruments Mackintosh produced in his lifetime.,8,0,male_masculine,8,5220
2256,700235,common_voice_en_20242.mp3,It may be the gases of the firing that caused the Martians inconvenience.,8,0,male_masculine,8,4368
2257,700234,common_voice_en_20241.mp3,"The Tradition teaches men how to cross the desert, and how their children should marry.",9,1,male_masculine,8,4704
2258,796172,common_voice_en_31063649.mp3,It is one of the oldest stone bridges in the city.,8,0,male_masculine,8,3708
2259,568679,common_voice_en_36864358.mp3,Brito stated in later years that he regretted writing the song.,10,2,male_masculine,8,6084
2260,1044650,common_voice_en_18896.mp3,He began to dig at the base of the sycamore.,8,0,male_masculine,8,3624
2261,1182160,common_voice_en_30531284.mp3,Together they placed fifth in the team competition.,8,0,male_masculine,8,5688
2262,796170,common_voice_en_31063647.mp3,"During his term as its president the ""Premetro"" was created.",8,0,male_masculine,8,5292
2263,497016,common_voice_en_151913.mp3,You can't believe it's not butter?,8,0,male_masculine,8,2352
2264,796187,common_voice_en_31094542.mp3,She attended the University of Guelph to partake in their veterinarian courses.,8,0,male_masculine,8,6696
2265,1069992,common_voice_en_18061206.mp3,Next Tuesday we must vote.,9,1,male_masculine,8,2976
2266,228871,common_voice_en_20285778.mp3,"The company hires professional singers, directors, designers and musicians for every production.",8,0,male_masculine,8,6024
2267,796225,common_voice_en_31384274.mp3,There were four weight categories for both men and women.,8,0,male_masculine,8,5328
2268,545018,common_voice_en_479866.mp3,The loafers and golf caddies were used to hanging out near the railway station.,8,0,male_masculine,8,6000
2269,1809876,common_voice_en_24010150.mp3,"His autobiography is called ""Moon River"" and Me"".",8,0,male_masculine,8,6372
2270,700189,common_voice_en_20196.mp3,How do I guess at the future?,8,0,male_masculine,8,1968
2271,1768321,common_voice_en_18284862.mp3,"Worryingly, the radio signal became weaker.",8,0,male_masculine,8,4080
2272,796188,common_voice_en_31094543.mp3,Cloud and lost.,8,0,male_masculine,8,2340
2273,1044682,common_voice_en_18931.mp3,The boy mumbled an answer that allowed him to avoid responding to her question.,8,0,male_masculine,8,5256
2274,796190,common_voice_en_31094565.mp3,He played college football at the University of Utah.,8,0,male_masculine,8,4248
2275,1069999,common_voice_en_18061220.mp3,The goalie is showing off his reflexes today.,8,0,male_masculine,8,3696
2276,922715,common_voice_en_275.mp3,You killed all three of them for nothing.,8,0,male_masculine,8,3984
2277,796191,common_voice_en_31094567.mp3,The expected attack had begun the previous day.,8,0,male_masculine,8,3636
2278,1824996,common_voice_en_32234678.mp3,He was educated at the University of Paris.,8,0,male_masculine,8,4320
2279,1182168,common_voice_en_30531292.mp3,His legs are excessively thick in comparison to the rest of his body.,8,0,male_masculine,8,5760
2280,1182169,common_voice_en_30531303.mp3,He was buried in the monumental cemetery of Turin.,8,0,male_masculine,8,4896
2281,796192,common_voice_en_31094568.mp3,The helicopter landed and the inspection got underway.,8,0,male_masculine,8,4248
2282,423289,common_voice_en_36946.mp3,It brought his heart into his mouth.,8,0,male_masculine,8,3192
2283,375977,common_voice_en_34092.mp3,They provided warnings about thieves and barbarian tribes.,10,2,male_masculine,8,4176
2284,796183,common_voice_en_31094511.mp3,All this led the Romanian government to abolish the institute.,8,0,male_masculine,8,4860
2285,700228,common_voice_en_20235.mp3,The boy spent a sleepless night.,8,0,male_masculine,8,1944
2286,769535,common_voice_en_34472307.mp3,He started his career at Beauchamps Solicitors in Dublin.,8,0,male_masculine,8,5832
2287,796184,common_voice_en_31094539.mp3,He is the Elmer Holmes Bobst Professor of Pharmacology at the University of Pennsylvania.,8,0,male_masculine,8,7632
2288,1818051,common_voice_en_26634262.mp3,"I don't care what anyone says, the masses are morons.",8,0,male_masculine,8,6696
2289,700226,common_voice_en_20233.mp3,"No, he heard a voice on the wind say.",8,0,male_masculine,8,2952
2290,1182163,common_voice_en_30531287.mp3,Van Leer.,8,0,male_masculine,8,2520
2291,1182374,common_voice_en_30531969.mp3,The association aims to rehabilitate war widows and battle casualties.,8,0,male_masculine,8,5940
2292,1347373,common_voice_en_147076.mp3,I have already described the appearance of that colossal bulk which was embedded in the ground.,8,0,male_masculine,8,6144
2293,406442,common_voice_en_37740842.mp3,In doing so it was possible to establish three specific sediment layers.,8,0,male_masculine,8,5508
2294,1182164,common_voice_en_30531288.mp3,The hosts India are the defending champions.,8,0,male_masculine,8,4716
2295,1827822,common_voice_en_35331314.mp3,Persson is buried at Norra burial ground in Stockholm.,8,0,male_masculine,8,6480
2296,700193,common_voice_en_20200.mp3,But then he remembered that he wasn't going to have to pay anything.,9,1,male_masculine,8,3960
2297,1182165,common_voice_en_30531289.mp3,A plaque explains the connection to Rev Robertson.,8,0,male_masculine,8,4896
2298,796227,common_voice_en_31384276.mp3,In the family he had four older sisters.,8,0,male_masculine,8,4536
2299,796185,common_voice_en_31094540.mp3,Produced by Warner Bros.,8,0,male_masculine,8,3096
2300,1182166,common_voice_en_30531290.mp3,He is the champion of the Kurash in the world.,8,0,male_masculine,8,4248
2301,1044641,common_voice_en_18887.mp3,Dense clouds of smoke or dust can be seen through a powerful telescope.,8,0,male_masculine,8,4896
2302,796177,common_voice_en_31063694.mp3,The lower storey is vaulted in two bays with chamfered ribs and carved bosses.,8,0,male_masculine,8,5796
2303,281971,common_voice_en_33932791.mp3,Patrick Breyer lives in Kiel.,12,4,male_masculine,8,2448
2304,1182151,common_voice_en_30531259.mp3,Some sources suggest he lived in Ujjain.,8,0,male_masculine,8,4716
2305,1182152,common_voice_en_30531266.mp3,These maps describe the cove located at the mouth of the river.,8,0,male_masculine,8,6156
2306,1182153,common_voice_en_30531267.mp3,There are also wheelchair spaces.,8,0,male_masculine,8,3528
2307,1182154,common_voice_en_30531273.mp3,Then she worked with the department of Arts and Culture for few years.,8,0,male_masculine,8,6120
2308,281970,common_voice_en_33932777.mp3,Lynch was arrested the following day and ultimately convicted of disorderly conduct.,8,0,male_masculine,8,6876
2309,801149,common_voice_en_17185.mp3,The boy knew the desert sensed his fear.,8,0,male_masculine,8,3792
2310,879404,common_voice_en_21962895.mp3,five,8,0,male_masculine,8,1776
2311,251304,common_voice_en_31648341.mp3,John Stands In Timber is her step brother.,8,0,male_masculine,8,4860
2312,1182155,common_voice_en_30531274.mp3,Work on the pumps and buildings was then started.,8,0,male_masculine,8,4860
2313,796179,common_voice_en_31094501.mp3,One from St Nicholas Arcades and one that originates on King Street.,8,0,male_masculine,8,5580
2314,801146,common_voice_en_17182.mp3,"He had studied Latin, Spanish, and theology.",10,2,male_masculine,8,3000
2315,374564,common_voice_en_21975976.mp3,four,8,0,male_masculine,8,2520
2316,801143,common_voice_en_17178.mp3,But now the sounds inside had stopped.,8,0,male_masculine,8,3240
2317,1182371,common_voice_en_30531965.mp3,The short deals about three young Aruban women.,8,0,male_masculine,8,4680
2318,1182171,common_voice_en_30531305.mp3,Safe traffic on the ice is generally from late December to early March.,8,0,male_masculine,8,7488
2319,796150,common_voice_en_31063538.mp3,In the first three rounds teams play each other three times.,8,0,male_masculine,8,4680
2320,796178,common_voice_en_31063695.mp3,He played another two seasons in the Canadian Football League for the Saskatchewan Roughriders.,8,0,male_masculine,8,6588
2321,796136,common_voice_en_31063473.mp3,It is developed by Fabulous Power Co.,8,0,male_masculine,8,3744
2322,796137,common_voice_en_31063474.mp3,It was overgrown and the mounds were being worn away.,8,0,male_masculine,8,4248
2323,796138,common_voice_en_31063490.mp3,The museum has incorporated many elements of modern technology.,8,0,male_masculine,8,4572
2324,1182148,common_voice_en_30531196.mp3,And accused him of interfering with the complete independence of Joseon.,8,0,male_masculine,8,6300
2325,796139,common_voice_en_31063491.mp3,She additionally has volunteered with Operation Smile and Feed it Forward.,8,0,male_masculine,8,5292
2326,801163,common_voice_en_17199.mp3,"Much better, said the old man.",8,0,male_masculine,8,2904
2327,796140,common_voice_en_31063492.mp3,It has also suffered from disappointing yield quantity in many years.,8,0,male_masculine,8,5256
2328,801161,common_voice_en_17197.mp3,"They were both silent for a time, observing the plaza and the townspeople.",8,0,male_masculine,8,4704
2329,1817607,common_voice_en_26062394.mp3,Their plans are original and they bring new solutions to architectonic problems.,8,0,male_masculine,8,7812
2330,801192,common_voice_en_17228.mp3,"I learned how to care for sheep, and I haven't forgotten how that's done.",8,0,male_masculine,8,4416
2331,772409,common_voice_en_13382.mp3,"In spite of this, I still believed that there were men in Mars.",8,0,male_masculine,8,4872
2332,801156,common_voice_en_17192.mp3,And the sand and gravel had been flung violently in every direction.,8,0,male_masculine,8,4032
2333,801155,common_voice_en_17191.mp3,"My name is Melchizedek, said the old man.",8,0,male_masculine,8,4560
2334,796142,common_voice_en_31063494.mp3,This resulted in the group leaving Columbia Records.,8,0,male_masculine,8,3852
2335,796143,common_voice_en_31063521.mp3,The music video was directed by Sylvie Weber.,8,0,male_masculine,8,4320
2336,1182149,common_voice_en_30531197.mp3,Cheerful Bullpen is the home Portland bar for the Buffalo Bills.,8,0,male_masculine,8,5976
2337,1182150,common_voice_en_30531198.mp3,"Her book ""When Memories Become Traumatic"" revolves around partition of India.",8,0,male_masculine,8,7416
2338,796144,common_voice_en_31063522.mp3,He was succeeded as Rector by Rev James Geoffrey Gordon.,8,0,male_masculine,8,5832
2339,796141,common_voice_en_31063493.mp3,The name Ordu is now reserved for the metropolitan municipality.,8,0,male_masculine,8,4932
2340,796160,common_voice_en_31063564.mp3,The Parliament unanimously voted to elect Sheares as president.,8,0,male_masculine,8,4644
2341,796193,common_voice_en_31098539.mp3,Ma Wong attended Virginia Tech.,8,0,male_masculine,8,3384
2342,796194,common_voice_en_31098540.mp3,The university includes the Department of Yoga Studies and Meditation.,8,0,male_masculine,8,4536
2343,922709,common_voice_en_269.mp3,I would appreciate if you could create a concise table.,8,0,male_masculine,8,5544
2344,796195,common_voice_en_31098541.mp3,I’m not talking about my love for humanity.,8,0,male_masculine,8,3636
2345,1392921,common_voice_en_17981489.mp3,There was a pause.,9,1,male_masculine,8,2136
2346,1182170,common_voice_en_30531304.mp3,Having previously played for Sri Pahang youth team.,8,0,male_masculine,8,5976
2347,1044665,common_voice_en_18912.mp3,"I'm not hiding anything, the boy answered.",8,0,male_masculine,8,3504
2348,1810026,common_voice_en_24010565.mp3,"She has since starred in the films ""The Brooklyn Heist"" and ""It's Complicated"".",10,2,male_masculine,8,8136
2349,796197,common_voice_en_31098543.mp3,Her sister Oksana Kurt is also an international volleyball player.,8,0,male_masculine,8,5436
2350,1182158,common_voice_en_30531277.mp3,A tsunami of about had struck Kamchatka.,8,0,male_masculine,8,6120
2351,340293,common_voice_en_141378.mp3,"When I returned to the common, the sun was setting.",8,0,male_masculine,8,3576
2352,1182159,common_voice_en_30531283.mp3,Rivers Student Prize from the Society for Medical Anthropology.,8,0,male_masculine,8,6336
2353,574184,common_voice_en_18044882.mp3,"Japanese culture is incredibly addictive, their buildings look amazing.",8,0,male_masculine,8,7224
2354,1044662,common_voice_en_18908.mp3,All things are one.,8,0,male_masculine,8,2496
2355,796166,common_voice_en_31063628.mp3,Hersey learned to play percussion and cello in his youth before switching to guitar.,8,0,male_masculine,8,6012
2356,355684,common_voice_en_18048.mp3,I wished I had a light to smoke by.,8,0,male_masculine,8,3312
2357,796167,common_voice_en_31063629.mp3,He also played running back late in the year.,8,0,male_masculine,8,4104
2358,801144,common_voice_en_17179.mp3,"The mixture took on a reddish color, almost the color of blood.",8,0,male_masculine,8,4704
2359,1182372,common_voice_en_30531967.mp3,He is married (with six children).,8,0,male_masculine,8,5616
2360,801141,common_voice_en_17176.mp3,"It means only that the heart does what it can, the alchemist said.",8,0,male_masculine,8,5160
2361,801140,common_voice_en_17175.mp3,"So, then try, he said to the Englishman.",8,0,male_masculine,8,4080
2362,796151,common_voice_en_31063539.mp3,His nomination came at the urging of presidential candidate Wendell Willkie.,8,0,male_masculine,8,5508
2363,796152,common_voice_en_31063550.mp3,He confessed to the killings while in custody.,8,0,male_masculine,8,3600
2364,575329,common_voice_en_32688015.mp3,Tarpaulins are pulled over the holds and the crew leave.,8,0,male_masculine,8,5904
2365,879402,common_voice_en_21962892.mp3,Firefox,8,0,male_masculine,8,2520
2366,1182156,common_voice_en_30531275.mp3,Khan is married to Altaf Hossain Kajol.,8,0,male_masculine,8,5976
2367,796154,common_voice_en_31063552.mp3,He took part in the suppression of the Taiping Rebellion.,8,0,male_masculine,8,3816
2368,1182379,common_voice_en_30531974.mp3,He is looking for the systems that underlay human behavior.,8,0,male_masculine,8,5328
2369,1182157,common_voice_en_30531276.mp3,She has won silver (Team event) in Asian para championships.,8,0,male_masculine,8,6408
2370,1702277,common_voice_en_30417579.mp3,It was created under the Philippine Organic Act from former territories of the province.,8,0,male_masculine,8,6336
2371,801130,common_voice_en_17165.mp3,The Englishman didn't answer him directly.,8,0,male_masculine,8,3096
2372,796155,common_voice_en_31063553.mp3,The appointed members were Henry Harry Vivian Whitchurch and Gerald Augustus Carlton Grell.,8,0,male_masculine,8,7236
2373,1182373,common_voice_en_30531968.mp3,"A reporter described her as the ""most photographed golfer in the world"".",8,0,male_masculine,8,7236
2374,503388,common_voice_en_12979.mp3,The boy was suddenly happy to be there at the warehouse.,8,0,male_masculine,8,4320
2375,796157,common_voice_en_31063561.mp3,Konda started his career with the Wa All Stars.,8,0,male_masculine,8,4104
2376,796158,common_voice_en_31063562.mp3,The production was shot in three days.,8,0,male_masculine,8,3024
2377,796159,common_voice_en_31063563.mp3,Ramachandran was also active in student politics.,8,0,male_masculine,8,4032
2378,801132,common_voice_en_17167.mp3,The boy was suddenly happy to be there at the warehouse.,8,0,male_masculine,8,4008
2379,898321,common_voice_en_37811307.mp3,Yes; but you must own she is very plain.,8,0,male_masculine,8,4500
2380,1182448,common_voice_en_30536489.mp3,Players in normal font have not been capped at senior level.,8,0,male_masculine,8,4500
2381,898323,common_voice_en_37811309.mp3,He distinguished forty-two different dialects in England and the Scottish Lowlands.,8,0,male_masculine,8,5580
2382,722961,common_voice_en_22094973.mp3,two,8,0,male_masculine,8,2232
2383,898325,common_voice_en_37811316.mp3,"Panton is located in northwestern Addison County, along the New York-Vermont border.",8,0,male_masculine,8,6516
2384,1182449,common_voice_en_30536490.mp3,Schriever was an academic voice teacher at the University of Music and Theatre Leipzig.,8,0,male_masculine,8,6336
2385,722965,common_voice_en_22095005.mp3,one,8,0,male_masculine,8,2184
2386,1140993,common_voice_en_21089805.mp3,It is also possible to generate ethanol out of cellulosic materials.,8,0,male_masculine,8,6360
2387,1182450,common_voice_en_30536491.mp3,Taling Chan is about from the city of Saraburi.,8,0,male_masculine,8,5760
2388,898326,common_voice_en_37811317.mp3,Dunlop later married the Argentine novelist Julio Cortazar.,8,0,male_masculine,8,5328
2389,796208,common_voice_en_31098604.mp3,The following crews entered the rally.,8,0,male_masculine,8,3348
2390,721113,common_voice_en_72360.mp3,"Looking through the telescope, I saw a circle of deep blue and the little round planet.",8,0,male_masculine,8,5568
2391,898331,common_voice_en_37811324.mp3,"It is the site of an annual whitewater boating event, the Avon Descent.",8,0,male_masculine,8,6336
2392,840550,common_voice_en_32755983.mp3,The port is accessible by bus from Zhongli Station of Taiwan Railways.,8,0,male_masculine,8,6444
2393,840551,common_voice_en_32755985.mp3,Hooe became an Alexandria businessmen as well as leading member of Confederate veterans organizations.,8,0,male_masculine,8,7632
2394,840552,common_voice_en_32755987.mp3,It was number one box office film in South Korea for two weeks.,8,0,male_masculine,8,4824
2395,898332,common_voice_en_37811325.mp3,Most public housing has now been sold off to private owners.,8,0,male_masculine,8,4716
2396,1182453,common_voice_en_30536499.mp3,Ground effects caused from the quake are still visible today.,8,0,male_masculine,8,4968
2397,1704092,common_voice_en_36530353.mp3,"In this case, the graph is called an edge-labeled graph.",8,0,male_masculine,8,6300
2398,898335,common_voice_en_37811333.mp3,The first permanent building was the craftsman style Southern Pacific Depot station and hotel.,8,0,male_masculine,8,6300
2399,828708,common_voice_en_18385354.mp3,Open the window.,8,0,male_masculine,8,2256
2400,943775,common_voice_en_115217.mp3,"Some went away while I was there, and other people came.",8,0,male_masculine,8,3240
2401,1182451,common_voice_en_30536492.mp3,He was named Bayside South Player of the Year in his senior season.,8,0,male_masculine,8,6480
2402,898251,common_voice_en_37811180.mp3,Civilians fled Kalbajar in April through mountains still covered in snow.,8,0,male_masculine,8,6048
2403,840538,common_voice_en_32755888.mp3,Elizabeth Stauffer now has children of her own.,8,0,male_masculine,8,4788
2404,1182442,common_voice_en_30536463.mp3,He played in two games.,8,0,male_masculine,8,3420
2405,760015,common_voice_en_16649.mp3,Most of them were staring quietly at the big table.,9,1,male_masculine,8,4464
2406,703567,common_voice_en_32128816.mp3,Demidova is the nearest rural locality.,8,0,male_masculine,8,4356
2407,1182443,common_voice_en_30536464.mp3,Trivedi started her scientific career at the Indian Institutes of Technology.,8,0,male_masculine,8,6660
2408,898308,common_voice_en_37811275.mp3,The soft packs are still sold with the traditional style packaging and design.,8,0,male_masculine,8,5580
2409,1805424,common_voice_en_23603830.mp3,It is located within the hotel on the third floor.,8,0,male_masculine,8,5256
2410,840547,common_voice_en_32755938.mp3,Those who had not been killed right away were buried alive.,8,0,male_masculine,8,4896
2411,898309,common_voice_en_37811277.mp3,Visitors are also able to view maintenance work being undertaken on the exhibits.,8,0,male_masculine,8,5940
2412,898319,common_voice_en_37811300.mp3,"His son Shealtiel was born in Babylon, as was Shealtiel's son Zerubbabel.",8,0,male_masculine,8,6876
2413,267926,common_voice_en_13890.mp3,"Why would a king be talking with a shepherd? the boy asked, awed and embarrassed.",8,0,male_masculine,8,5616
2414,898312,common_voice_en_37811284.mp3,"To this day, Ian Fleming Publications has never disclosed or confirmed the author's identity.",8,0,male_masculine,8,6768
2415,1090687,common_voice_en_32566192.mp3,He later graduated from Anadolu University School of Communication.,8,0,male_masculine,8,4788
2416,1182445,common_voice_en_30536466.mp3,Spring and fall are the most favorable seasons to visit Navajo Dome.,8,0,male_masculine,8,5760
2417,1182446,common_voice_en_30536467.mp3,He also became an Alderman of London.,8,0,male_masculine,8,5760
2418,840549,common_voice_en_32755946.mp3,I can only imagine getting close to someone.,8,0,male_masculine,8,3780
2419,898218,common_voice_en_37811137.mp3,"The process is private and confidential, possibly enforced by law.",8,0,male_masculine,8,5436
2420,584941,common_voice_en_549414.mp3,I was impatient to see it opened.,8,0,male_masculine,8,2256
2421,898282,common_voice_en_37811218.mp3,Am I a spider with the limitations of a pig?,8,0,male_masculine,8,4248
2422,898317,common_voice_en_37811298.mp3,Crew and passengers took to her boats and abandoned her.,8,0,male_masculine,8,5400
2423,898318,common_voice_en_37811299.mp3,"Ward was buried in a pauper's grave in Malvern, Worcestershire.",8,0,male_masculine,8,5940
2424,840548,common_voice_en_32755945.mp3,She is Treasurer for the Council of University Classical Departments.,8,0,male_masculine,8,5184
2425,943783,common_voice_en_115226.mp3,"Down below in the darkness were hundreds of people, sleeping in peace.",8,0,male_masculine,8,4968
2426,1112429,common_voice_en_33747054.mp3,Various expansions would take place on the Rossdale site and Edmonton continued to grow.,8,0,male_masculine,8,6588
2427,840567,common_voice_en_32756575.mp3,The Raptors struggled with injuries throughout the season.,8,0,male_masculine,8,4824
2428,898247,common_voice_en_37811174.mp3,"She advanced quickly, becoming the South American champion within four years.",8,0,male_masculine,8,6048
2429,1219230,common_voice_en_35059398.mp3,"There are two primary types of the plans, governmental and non-governmental.",8,0,male_masculine,8,5796
2430,1827736,common_voice_en_35277401.mp3,"Grain and opium have, in the past, been main agricultural products.",8,0,male_masculine,8,6696
2431,1414002,common_voice_en_30405881.mp3,Johnston.,8,0,male_masculine,8,2124
2432,469339,common_voice_en_75955.mp3,"At that time, it was quite clear in my own mind that the thing had come from the planet Mars.",8,0,male_masculine,8,6000
2433,647459,common_voice_en_35120786.mp3,"However, her mother has revealed that he was an African-American soldier, Master-Sergeant Robert Barkley.",8,0,male_masculine,8,9648
2434,1219186,common_voice_en_35059203.mp3,The Philippine government has established several flood warning stations along the river.,8,0,male_masculine,8,5940
2435,898338,common_voice_en_37811342.mp3,Now everyone refers to it as the Mexican Riviera.,8,0,male_masculine,8,4608
2436,840569,common_voice_en_32756578.mp3,It fought mostly with the Army of Northern Virginia.,8,0,male_masculine,8,4356
2437,840570,common_voice_en_32756580.mp3,She is the first brand ambassador of this company.,8,0,male_masculine,8,4104
2438,840539,common_voice_en_32755889.mp3,Up until then Linden Hall held this honour.,8,0,male_masculine,8,4140
2439,1444559,common_voice_en_35972645.mp3,All shipping for clay now goes to Fowey.,8,0,male_masculine,8,4752
2440,898245,common_voice_en_37811172.mp3,This enabled him to continue his education in Paris.,8,0,male_masculine,8,4788
2441,1515983,common_voice_en_18171416.mp3,What will you have to drink?,8,0,male_masculine,8,2256
2442,922821,common_voice_en_385.mp3,Did you finish the interview?,8,0,male_masculine,8,3240
2443,1600794,common_voice_en_17426611.mp3,They landed on the dark side of the moon.,8,0,male_masculine,8,3576
2444,296247,common_voice_en_20285339.mp3,"Previously, all ""poleis"" had their own calendars based on their respective festivals.",9,1,male_masculine,8,6792
2445,580736,common_voice_en_69192.mp3,The night was warm and I was thirsty.,8,0,male_masculine,8,3072
2446,840541,common_voice_en_32755891.mp3,In time her daughter Christian married Robert who was the son of Ninian Bryden.,8,0,male_masculine,8,6012
2447,1812624,common_voice_en_24361241.mp3,It is still in active use.,8,0,male_masculine,8,4068
2448,898339,common_voice_en_37811343.mp3,"In retirement, he served as an officer of several transportation companies.",8,0,male_masculine,8,5148
2449,898340,common_voice_en_37811344.mp3,Planning permission was turned down but Center Parcs won on appeal.,8,0,male_masculine,8,5256
2450,300428,common_voice_en_37160.mp3,I thought you were going to teach me some of the things you know.,8,0,male_masculine,8,3384
2451,1182454,common_voice_en_30536500.mp3,Su Mao was defeated and fled to Huling.,8,0,male_masculine,8,4248
2452,1182401,common_voice_en_30531999.mp3,They are all communities of craft artisans since ancient times.,8,0,male_masculine,8,6228
2453,840554,common_voice_en_32755990.mp3,His style was based largely upon later works by the Nazarene movement.,8,0,male_masculine,8,5292
2454,898342,common_voice_en_37811348.mp3,After a brief stay it was flown on to Offutt Air Force Base.,8,0,male_masculine,8,6120
2455,898313,common_voice_en_37811285.mp3,"The building exploded, killing one company man and injuring several others.",8,0,male_masculine,8,5436
2456,898314,common_voice_en_37811286.mp3,"Harris was born to Leon Senior and Lorrene Harris in Akron, Ohio.",8,0,male_masculine,8,5508
2457,840531,common_voice_en_32755803.mp3,Bernabei was born in Tarquinia.,8,0,male_masculine,8,3564
2458,1219262,common_voice_en_35059562.mp3,She was the oldest daughter in her family.,8,0,male_masculine,8,3636
2459,898330,common_voice_en_37811322.mp3,"Learning this, Richard pushed his army forward, spending Christmas at Latrun.",8,0,male_masculine,8,5148
2460,840564,common_voice_en_32756540.mp3,There are some decorated narrow strips on the walls.,8,0,male_masculine,8,4248
2461,723459,common_voice_en_82887.mp3,The top of the cylinder was rotating on its body.,8,0,male_masculine,8,3864
2462,721129,common_voice_en_72379.mp3,"Down below in the darkness were hundreds of people, sleeping in peace.",8,0,male_masculine,8,6048
2463,1141218,common_voice_en_30155907.mp3,He was the only survivor of four born children.,8,0,male_masculine,8,5436
2464,1198235,common_voice_en_38648315.mp3,Karma yoga is discussed in many other Hindu texts.,8,0,male_masculine,8,5436
2465,840565,common_voice_en_32756541.mp3,He was an expert in the field of dynamics and the approximation of.,8,0,male_masculine,8,4896
2466,898248,common_voice_en_37811175.mp3,The Speaker also acts as President of Israel when the President is incapacitated.,8,0,male_masculine,8,6120
2467,840566,common_voice_en_32756542.mp3,"A combination of several phenotypic characteristics distinguish this species from others in genus ""Malassezia"".",8,0,male_masculine,8,7920
2468,1127247,common_voice_en_18488150.mp3,"Quite a nice view of the town from up there, and it's easy to find.",8,0,male_masculine,8,5016
2469,1112419,common_voice_en_33735616.mp3,This progress was due to light favorable wind conditions.,8,0,male_masculine,8,5652
2470,723410,common_voice_en_82835.mp3,A boy came running towards me.,9,1,male_masculine,8,2904
2471,1182415,common_voice_en_30536393.mp3,He also served as company manager of the Canadian Players.,8,0,male_masculine,8,5328
2472,1182416,common_voice_en_30536394.mp3,The Queen Mary Fringe Tiara secured her veil.,8,0,male_masculine,8,4428
2473,1182417,common_voice_en_30536395.mp3,Chadha.,8,0,male_masculine,8,2340
2474,780582,common_voice_en_9152.mp3,Most of them were staring quietly at the big table.,12,4,male_masculine,8,2904
2475,760003,common_voice_en_16637.mp3,"I had the ""everyone has Gary Busey's teeth"" dream again.",8,0,male_masculine,8,4872
2476,1182418,common_voice_en_30536396.mp3,Driscoll has hollows in its southeastern quadrant.,8,0,male_masculine,8,4788
2477,1587153,common_voice_en_18176324.mp3,The train pulled into the station.,8,0,male_masculine,8,2976
2478,1182419,common_voice_en_30536397.mp3,The structure has two rectangular portals on the ground floor flanked by square windows.,8,0,male_masculine,8,6588
2479,426569,common_voice_en_32222448.mp3,Atlanta had two selections in the draft.,8,0,male_masculine,8,4464
2480,898258,common_voice_en_37811187.mp3,For decades these were the major industries in the municipality.,8,0,male_masculine,8,5040
2481,898304,common_voice_en_37811269.mp3,Kuakata beach is the main tourist spot in the division.,8,0,male_masculine,8,4500
2482,780543,common_voice_en_9112.mp3,It seemed he had made the long journey for nothing.,12,4,male_masculine,8,3384
2483,621981,common_voice_en_64713.mp3,I'm trying to explain to my mother how to get pictures off her phone.,8,0,male_masculine,8,6192
2484,898260,common_voice_en_37811189.mp3,He graduated from Boston College with a bachelor's degree in history.,8,0,male_masculine,8,5616
2485,898262,common_voice_en_37811191.mp3,The division of genus types into species is as shown in the following table.,8,0,male_masculine,8,6120
2486,1767330,common_voice_en_18016158.mp3,Asexual means you don't find anyone sexually attractive.,8,0,male_masculine,8,3672
2487,1182420,common_voice_en_30536404.mp3,Larvae will feed internally on the bark and woody materials.,8,0,male_masculine,8,4968
2488,817153,common_voice_en_18010523.mp3,Fasten two pins on each side.,8,0,male_masculine,8,3312
2489,1182421,common_voice_en_30536405.mp3,He had brown hair and notable recent dental work.,8,0,male_masculine,8,4248
2490,1763757,common_voice_en_36711466.mp3,They sought advice on a conservative seminary to complete their studies.,8,0,male_masculine,8,5832
2491,898267,common_voice_en_37811199.mp3,He subsequently took a degree in divinity at the Harvard Divinity School.,8,0,male_masculine,8,5580
2492,1182403,common_voice_en_30532001.mp3,It is also home to three Nelson Mandela University campuses.,8,0,male_masculine,8,5940
2493,898259,common_voice_en_37811188.mp3,Her accommodation was gutted by fire and four crewmembers were killed.,8,0,male_masculine,8,5868
2494,1398776,common_voice_en_58762.mp3,So his heart was quiet for an entire afternoon.,8,0,male_masculine,8,3384
2495,760019,common_voice_en_16653.mp3,And then he perceived it very slowly.,8,0,male_masculine,8,3504
2496,1182405,common_voice_en_30532003.mp3,The treaty also allowed for the construction of the Panama Railway.,8,0,male_masculine,8,5688
2497,1030429,common_voice_en_209782.mp3,A guy fishing in a lake almost gets pulled into the water by something,8,0,male_masculine,8,3864
2498,1182406,common_voice_en_30532004.mp3,It is on display in the permanent exhibition of the National Gallery in Prague.,8,0,male_masculine,8,7560
2499,1825490,common_voice_en_32356802.mp3,He served on the Portfolio Committee on Public Service and Administration.,8,0,male_masculine,8,6480
2500,1808039,common_voice_en_23908666.mp3,The wood is white and brittle.,8,0,male_masculine,8,3744
2501,1182407,common_voice_en_30532005.mp3,They are most commonly found in Australia.,8,0,male_masculine,8,3996
2502,780604,common_voice_en_9174.mp3,"But before I go, I want to tell you a little story.",10,2,male_masculine,8,3624
2503,1182408,common_voice_en_30532006.mp3,In contrast the National Radio and Television Administration regulates radio and other media content.,8,0,male_masculine,8,8460
2504,1243906,common_voice_en_32546312.mp3,This can also allow incineration.,8,0,male_masculine,8,3636
2505,219454,common_voice_en_20283909.mp3,"However, by turbo engines were becoming faster, more reliable and easier to drive.",10,2,male_masculine,8,6840
2506,898254,common_voice_en_37811183.mp3,Congressman and House Majority Leader Dick Armey.,8,0,male_masculine,8,4356
2507,1182410,common_voice_en_30536383.mp3,In such cases sickness of children was seen as the spirits were unhappy.,8,0,male_masculine,8,8100
2508,898256,common_voice_en_37811185.mp3,A group of Korean Americans led the project to establish the Memorial.,8,0,male_masculine,8,5940
2509,1182404,common_voice_en_30532002.mp3,Voznesensky is the nearest rural locality.,8,0,male_masculine,8,5040
2510,1182411,common_voice_en_30536384.mp3,Rind was soon appointed public printer.,8,0,male_masculine,8,3960
2511,1182412,common_voice_en_30536385.mp3,His mother is Russian and his father is Eritrean.,8,0,male_masculine,8,4680
2512,501273,common_voice_en_85943.mp3,Everyone seemed very excited.,8,0,male_masculine,8,4680
2513,1182413,common_voice_en_30536386.mp3,The plan was considered uneconomical and was shelved.,8,0,male_masculine,8,4968
2514,1182414,common_voice_en_30536387.mp3,The lower lip is divided into three lobes.,8,0,male_masculine,8,4536
2515,1090627,common_voice_en_32545528.mp3,A commemorative stamp was also issued that day.,8,0,male_masculine,8,3600
2516,1182409,common_voice_en_30532007.mp3,It didn’t just happen. We weren’t born this way.,8,0,male_masculine,8,5436
2517,1182433,common_voice_en_30536443.mp3,Chinese incursions into the area have been reported in the press.,8,0,male_masculine,8,6120
2518,1182434,common_voice_en_30536444.mp3,Equipment can be taken from already injured players.,8,0,male_masculine,8,6516
2519,759990,common_voice_en_16624.mp3,"That night, there was another jetting out of gas from the distant planet.",8,0,male_masculine,8,4848
2520,1430034,common_voice_en_38034451.mp3,"Her latter-day work in television included an episode of ""Law and Order"".",8,0,male_masculine,8,6120
2521,1182435,common_voice_en_30536445.mp3,It is endemic to the island of Taiwan and Southeast Asia.,8,0,male_masculine,8,5688
2522,898283,common_voice_en_37811221.mp3,Curran scolds Hawkins for his carelessness that caused Graham's death.,8,0,male_masculine,8,5760
2523,898287,common_voice_en_37811226.mp3,It is today the second oldest church bell in Sweden.,8,0,male_masculine,8,4500
2524,840534,common_voice_en_32755806.mp3,This resulted in the deaths of two terrorists.,8,0,male_masculine,8,4212
2525,898288,common_voice_en_37811227.mp3,Some of the casting seems a little off.,8,0,male_masculine,8,3780
2526,1182402,common_voice_en_30532000.mp3,Some of his work is held by the National Gallery of Canada.,8,0,male_masculine,8,5796
2527,760034,common_voice_en_16668.mp3,I thought about the difficulties in translation that might arise.,8,0,male_masculine,8,4152
2528,1182439,common_voice_en_30536455.mp3,There have been several visits by leaders and Foreign Ministers of both nations.,8,0,male_masculine,8,6156
2529,898289,common_voice_en_37811228.mp3,The violence has been causing disruption in the trade and markets.,8,0,male_masculine,8,5328
2530,840535,common_voice_en_32755859.mp3,The Jaguars played their home games at Jaguar Field.,8,0,male_masculine,8,4536
2531,898292,common_voice_en_37811236.mp3,"This poses a problem for Harpo, who never talks.",8,0,male_masculine,8,4500
2532,1182440,common_voice_en_30536456.mp3,Ramona currently serves on the board of directors for the American Geriatrics Society.,8,0,male_masculine,8,6300
2533,898293,common_voice_en_37811242.mp3,Each class has a unique set of spells that other classes can not obtain.,8,0,male_masculine,8,5616
2534,1182441,common_voice_en_30536457.mp3,He died at the hotel.,8,0,male_masculine,8,3420
2535,898296,common_voice_en_37811252.mp3,The Corps has no battle honours.,8,0,male_masculine,8,3996
2536,840537,common_voice_en_32755887.mp3,"Subsequent examinations ruled that his death was due to ""acute and chronic alcohol use"".",8,0,male_masculine,8,6552
2537,898302,common_voice_en_37811266.mp3,"Stephen-Daly has also appeared in ""The Bill"" as Kristen Shaw, a sexy drug baroness.",8,0,male_masculine,8,8496
2538,898303,common_voice_en_37811267.mp3,"Related terms include dude, tenderfoot, and greenhorn.",8,0,male_masculine,8,5796
2539,1182438,common_voice_en_30536454.mp3,He ask him to come to the village.,8,0,male_masculine,8,3456
2540,1182423,common_voice_en_30536407.mp3,It was led by coach Arvid Smit.,8,0,male_masculine,8,4176
2541,772343,common_voice_en_13315.mp3,But they were not there.,8,0,male_masculine,8,2712
2542,1182425,common_voice_en_30536425.mp3,All cars feature longitudinal seating throughout.,8,0,male_masculine,8,3996
2543,772371,common_voice_en_13344.mp3,He noticed the unequal cooling of its surface.,8,0,male_masculine,8,3984
2544,1182426,common_voice_en_30536426.mp3,The Western Association folded during the season.,8,0,male_masculine,8,3600
2545,1182427,common_voice_en_30536427.mp3,Monaghan was considered an authority on the disease.,8,0,male_masculine,8,4860
2546,840532,common_voice_en_32755804.mp3,Later she began experimenting with technical means to create graphic works.,8,0,male_masculine,8,5112
2547,898269,common_voice_en_37811201.mp3,He is also the father of three children.,8,0,male_masculine,8,4140
2548,898271,common_voice_en_37811204.mp3,It also receives little snow or rainfall compared to surrounding areas.,8,0,male_masculine,8,5580
2549,1182428,common_voice_en_30536433.mp3,A lot of his works are influenced by Lemkos folklore.,8,0,male_masculine,8,5328
2550,772366,common_voice_en_13339.mp3,Some of those who saw its flight say it travelled with a hissing sound.,8,0,male_masculine,8,5016
2551,1182432,common_voice_en_30536437.mp3,While they were in New York they recorded material at Converse Rubber Tracks.,8,0,male_masculine,8,6480
2552,780520,common_voice_en_9088.mp3,"In some places, the ground was covered with the salt of dried-up lakes.",11,3,male_masculine,8,5424
2553,780519,common_voice_en_9087.mp3,But I didn’t think that it contained any living creature.,8,0,male_masculine,8,4176
2554,1182430,common_voice_en_30536435.mp3,This order also specified the deployment of troops.,8,0,male_masculine,8,5076
2555,898273,common_voice_en_37811206.mp3,"He once referred to State legislators as ""pimps"".",8,0,male_masculine,8,5040
2556,780517,common_voice_en_9085.mp3,"The animals were exhausted, and the men talked among themselves less and less.",10,2,male_masculine,8,5424
2557,760021,common_voice_en_16655.mp3,The burning fire had been extinguished.,9,1,male_masculine,8,2736
2558,898275,common_voice_en_37811209.mp3,The Priest asks Balda to collect a fabricated debt from sea devils.,8,0,male_masculine,8,6156
2559,898276,common_voice_en_37811210.mp3,"He opened a wholesale grocery business in Cincinnati, then moved it to Milwaukee.",8,0,male_masculine,8,5580
2560,898277,common_voice_en_37811211.mp3,"Educated at Saint John's Marist Brothers, in Hawthorn and Xavier College in Kew.",8,0,male_masculine,8,6840
2561,1182431,common_voice_en_30536436.mp3,The roses are evaluated five times each growing season by rose experts.,8,0,male_masculine,8,6480
2562,759992,common_voice_en_16626.mp3,"As soon as he saw me among the crowd, he called to me to come down.",9,1,male_masculine,8,4368
2563,1182429,common_voice_en_30536434.mp3,She has received multiple national awards.,8,0,male_masculine,8,4680
2564,1182399,common_voice_en_30531996.mp3,The current season tier of member federation clubs is shown in parentheses.,8,0,male_masculine,8,6516
2565,780003,common_voice_en_73998.mp3,"At that time, it was quite clear in my own mind that the thing had come from the planet Mars.",8,0,male_masculine,8,6696
2566,721166,common_voice_en_72422.mp3,Can I get a woot woot!?,8,0,male_masculine,8,1656
2567,840619,common_voice_en_32757017.mp3,Ravens were named after the Australian raven.,8,0,male_masculine,8,3744
2568,1058178,common_voice_en_121120.mp3,"At once, he connected the two incidents.",8,0,male_masculine,8,3528
2569,628178,common_voice_en_11829.mp3,"Sit down, and let me treat you to something, said the boy.",9,1,male_masculine,8,4536
2570,840620,common_voice_en_32757018.mp3,"Tsikhanouskaya stated that Protasevich ""faces the death penalty"" in Belarus.",8,0,male_masculine,8,5904
2571,1182398,common_voice_en_30531995.mp3,The film was the Kannada movie debut of actress Preetha Vijayakumar.,8,0,male_masculine,8,6588
2572,843972,common_voice_en_12028.mp3,He wasn't asking for help.,8,0,male_masculine,8,3648
2573,840621,common_voice_en_32757019.mp3,Zahn spent ten years in the private sector with trial and litigation firms.,8,0,male_masculine,8,5904
2574,1828499,common_voice_en_36288577.mp3,"McGuffey is buried in the University of Virginia Cemetery, in Charlottesville, Virginia.",8,0,male_masculine,8,9036
2575,1182397,common_voice_en_30531994.mp3,The rockets are all built and assembled in the United Kingdom.,8,0,male_masculine,8,5040
2576,464595,common_voice_en_16094.mp3,Two large rooster statues stand on the sidewalk in front of a restaurant.,8,0,male_masculine,8,4800
2577,385774,common_voice_en_24537.mp3,I heard a peculiar humming sound from the pit.,8,0,male_masculine,8,3552
2578,1832000,common_voice_en_37640751.mp3,It premiered at the Venice International Film Festival.,8,0,male_masculine,8,5040
2579,840622,common_voice_en_32757020.mp3,Williams was not returned to the mayoral committee.,8,0,male_masculine,8,3852
2580,628173,common_voice_en_11824.mp3,The thing itself was almost entirely buried in sand.,10,2,male_masculine,8,4104
2581,598440,common_voice_en_38084700.mp3,"His second book, ""Salvinorin,"" addressed the effects of ""Salvia divinorum"".",8,0,male_masculine,8,7020
2582,840623,common_voice_en_32757021.mp3,Canada qualified one female archer.,8,0,male_masculine,8,3348
2583,598438,common_voice_en_38077745.mp3,The Shari River flows along the northwestern outskirts of the city.,8,0,male_masculine,8,4824
2584,1182396,common_voice_en_30531993.mp3,He was the head of the petitions committee during tenure at the Parliament.,8,0,male_masculine,8,5220
2585,1182395,common_voice_en_30531992.mp3,Talukdar was married to Ayesha Khanam.,8,0,male_masculine,8,6156
2586,628176,common_voice_en_11827.mp3,Did you see the garden that it took the master gardener ten years to create?,10,2,male_masculine,8,5688
2587,840634,common_voice_en_32757042.mp3,Edwards Power Plant across the river.,8,0,male_masculine,8,3492
2588,945050,common_voice_en_37988933.mp3,"All that was left of Bavadra's party was the name, he said.",8,0,male_masculine,8,4824
2589,1833448,common_voice_en_38519135.mp3,The name of the mountain dates back to ancient times.,8,0,male_masculine,8,4320
2590,840603,common_voice_en_32756989.mp3,He also taught maritime law and international law at the Shanghai Maritime University.,8,0,male_masculine,8,5868
2591,598455,common_voice_en_38084842.mp3,Mention of Dag Ringsson did not appear after this point.,8,0,male_masculine,8,6012
2592,840604,common_voice_en_32756990.mp3,They are now based in Los Angeles.,8,0,male_masculine,8,2916
2593,840605,common_voice_en_32756991.mp3,The idea for Mir was conceived by President Nazarbayev.,8,0,male_masculine,8,4500
2594,840606,common_voice_en_32756992.mp3,Gundel’s research focused primarily on the interface between linguistic theory and pragmatics.,8,0,male_masculine,8,6768
2595,598452,common_voice_en_38084798.mp3,"On the three pilgrimage festivals, the melody shown here is the tune favored.",8,0,male_masculine,8,8712
2596,253587,common_voice_en_31694741.mp3,Columbia finished sixth in the Ivy League.,8,0,male_masculine,8,4248
2597,840610,common_voice_en_32757002.mp3,All links are decorated with diamonds.,8,0,male_masculine,8,3240
2598,840607,common_voice_en_32756993.mp3,One participant was filmed doing the Nazi salute.,8,0,male_masculine,8,4032
2599,840608,common_voice_en_32756994.mp3,The deanery is headquartered in the town of Harstad in Harstad Municipality.,8,0,male_masculine,8,5256
2600,945061,common_voice_en_37988986.mp3,The game pitted Jonesboro High School against cross-town rival Nettleton High School.,10,2,male_masculine,8,6372
2601,898219,common_voice_en_37811138.mp3,The Polar glacier must be regarded as strictly atmospheric in its increments.,8,0,male_masculine,8,5580
2602,598449,common_voice_en_38084715.mp3,"Tom Hanks is the narrator, co-writer and co-producer.",8,0,male_masculine,8,5400
2603,898216,common_voice_en_37811133.mp3,It is best known for being the location of Martinsville Speedway.,8,0,male_masculine,8,5076
2604,385762,common_voice_en_24525.mp3,The end of the cylinder was still as Ogilvy and Henderson had left it.,9,1,male_masculine,8,5256
2605,628182,common_voice_en_11833.mp3,"just a memory, right now it signified shade, water, and a refuge from the war.",9,1,male_masculine,8,6744
2606,326642,common_voice_en_32651067.mp3,A maze of underground roads runs below the square.,8,0,male_masculine,8,6300
2607,385764,common_voice_en_24527.mp3,I have already described the appearance of that colossal bulk which was embedded in the ground.,8,0,male_masculine,8,5568
2608,840609,common_voice_en_32756996.mp3,She began writing poetry when she was eight years old.,8,0,male_masculine,8,3816
2609,598451,common_voice_en_38084723.mp3,"Recordings are deliberately low fidelity, often incorporating ambient sounds and samples of speech.",8,0,male_masculine,8,7632
2610,598441,common_voice_en_38084702.mp3,It is also affiliated to the Kwame Nkrumah University of Science and Technology.,8,0,male_masculine,8,6732
2611,1182388,common_voice_en_30531983.mp3,It feels fresh and is suitable for capturing.,8,0,male_masculine,8,4140
2612,932415,common_voice_en_30236771.mp3,They were an independent team.,8,0,male_masculine,8,2916
2613,512589,common_voice_en_95064.mp3,The turf and gravel around it seemed charred as if by a sudden explosion.,8,0,male_masculine,8,6600
2614,664511,common_voice_en_39477716.mp3,"He spent his time constructing fortifications for the new capital city, Richmond.",8,0,male_masculine,8,6948
2615,1182387,common_voice_en_30531982.mp3,The legislative structure of the province is unicameral.,8,0,male_masculine,8,5148
2616,1182386,common_voice_en_30531981.mp3,Walsh also ran the team in an excellent manner.,8,0,male_masculine,8,4536
2617,1182385,common_voice_en_30531980.mp3,The Spanish forces had been defeated the day before by the same Cuban forces.,8,0,male_masculine,8,6228
2618,1182384,common_voice_en_30531979.mp3,Pilla was sometimes less than diplomatic.,8,0,male_masculine,8,4428
2619,598432,common_voice_en_38077728.mp3,The cake is held together by apricot jam and covered with marzipan.,8,0,male_masculine,8,5832
2620,945104,common_voice_en_38143813.mp3,Closeup photographs of a distraught Riefenstahl survive from that day.,10,2,male_masculine,8,5256
2621,1182383,common_voice_en_30531978.mp3,Many of the Soviet fatalities originated from Saint Petersburg in Russia.,8,0,male_masculine,8,6048
2622,664492,common_voice_en_39476708.mp3,"Situated beside the New Hampshire border, Brownfield is drained by the Saco River.",8,0,male_masculine,8,6192
2623,1398803,common_voice_en_58789.mp3,The two men hurried back and found the cylinder still lying in the same position.,8,0,male_masculine,8,4560
2624,898212,common_voice_en_37811127.mp3,"The town is about south-south-west of the Provincial Capitol, Bacolod City.",8,0,male_masculine,8,6660
2625,1182112,common_voice_en_30531136.mp3,She set the Venezuelan national junior records in both discus and shot put.,8,0,male_masculine,8,8496
2626,598429,common_voice_en_38077723.mp3,The society and Agarwal family berates Genda for her actions.,8,0,male_masculine,8,5580
2627,598428,common_voice_en_38077721.mp3,It symbolizes the warm and respectful relations between the French and the Americans.,8,0,male_masculine,8,6300
2628,1824447,common_voice_en_32106642.mp3,Town were drawn away to Cambridge United in the first round.,8,0,male_masculine,8,5076
2629,298552,common_voice_en_20284779.mp3,"According to Kate, the couple later married in Valdosta, Georgia.",8,0,male_masculine,8,5520
2630,922782,common_voice_en_346.mp3,If you don't stop following me I'll call the police.,8,0,male_masculine,8,4008
2631,194849,common_voice_en_37619322.mp3,One specific case relates to the intricate network of local governance from village chiefs.,8,0,male_masculine,8,7776
2632,1182111,common_voice_en_30531135.mp3,Margaret Ann Louise Jobson is married and has one son.,8,0,male_masculine,8,7308
2633,341109,common_voice_en_18369220.mp3,A gentleman A gipsy.,8,0,male_masculine,8,2904
2634,879565,common_voice_en_30423452.mp3,They also released an image film for the logo.,8,0,male_masculine,8,4788
2635,385779,common_voice_en_24542.mp3,He approached the mass and was surprised at the size and the shape.,8,0,male_masculine,8,4032
2636,598435,common_voice_en_38077737.mp3,They give an impression of how richly Saint Mary's church was once furnished.,8,0,male_masculine,8,6300
2637,598434,common_voice_en_38077736.mp3,"Boeing's test pilot, Herb Munter, soon cracked up the plane.",8,0,male_masculine,8,6120
2638,1182394,common_voice_en_30531989.mp3,He advised her on her first literary works.,8,0,male_masculine,8,4068
2639,898213,common_voice_en_37811129.mp3,He was buried in the Union Cemetery in Bakersfield.,8,0,male_masculine,8,5400
2640,359826,common_voice_en_170599.mp3,Absolutely despicable that gingerbread men are forced to live in houses made of their own flesh.,8,0,male_masculine,8,9360
2641,840626,common_voice_en_32757024.mp3,It grows in woodland and often in sandstone areas.,8,0,male_masculine,8,4320
2642,598424,common_voice_en_38077706.mp3,Another significant challenge to the weapon focus effect has been its ecological validity.,8,0,male_masculine,8,6732
2643,840635,common_voice_en_32757043.mp3,She is the daughter of Adalberto Ferreira da Silva and Irani Aparecida da Silva.,8,0,male_masculine,8,6516
2644,1182389,common_voice_en_30531984.mp3,The media player is now separate from the notifications.,8,0,male_masculine,8,4896
2645,1182106,common_voice_en_30531130.mp3,The aircraft was privately owned at the time of the crash.,8,0,male_masculine,8,5436
2646,1004578,common_voice_en_31863315.mp3,"Dutrow wrote the textbook ""Manual of Mineral Science"".",8,0,male_masculine,8,5616
2647,843985,common_voice_en_12041.mp3,Then she filled her vessel with water and left.,8,0,male_masculine,8,4992
2648,598448,common_voice_en_38084714.mp3,Its primary settlement is Basingstoke.,8,0,male_masculine,8,3564
2649,1182393,common_voice_en_30531988.mp3,The Platform has planned campaigns against fascism and racism.,8,0,male_masculine,8,4968
2650,840636,common_voice_en_32757044.mp3,I want to eat cake.,8,0,male_masculine,8,2124
2651,840637,common_voice_en_32757045.mp3,Buonamici emerged as an editor of piano compositions by Beethoven and Schubert.,8,0,male_masculine,8,6156
2652,1182108,common_voice_en_30531132.mp3,Actress Doan Ly portrays Anna May Wong in enacted sequences of the documentary.,8,0,male_masculine,8,8748
2653,1182109,common_voice_en_30531133.mp3,Fleischer fostered two street children from Mexico.,8,0,male_masculine,8,4716
2654,1182390,common_voice_en_30531985.mp3,Elytra covered with coarse punctures.,8,0,male_masculine,8,3816
2655,598444,common_voice_en_38084705.mp3,Ascutney Hospital and Health Center is located in Windsor.,8,0,male_masculine,8,4536
2656,598420,common_voice_en_38077690.mp3,"A ""mini-tower"" case will typically have only one or two external bays.",8,0,male_masculine,8,6732
2657,840543,common_voice_en_32755904.mp3,Majority of the waste were sent to landfills.,8,0,male_masculine,8,3384
2658,840544,common_voice_en_32755907.mp3,He died in the ambulance taking him to the hospital.,8,0,male_masculine,8,3924
2659,898229,common_voice_en_37811149.mp3,"Vegetation is primarily pinyon-juniper, montane shrub, and sagebrush steppe.",8,0,male_masculine,8,8856
2660,725522,common_voice_en_48484.mp3,"One can imagine these two, covered with sand, running up the little street in the bright sunlight.",8,0,male_masculine,8,6744
2661,725523,common_voice_en_48485.mp3,"Revenge is not my style, but obviously accidents will happen.",8,0,male_masculine,8,4656
2662,922840,common_voice_en_404.mp3,Take hold of the cover.,8,0,male_masculine,8,2592
2663,125428,common_voice_en_35194001.mp3,The house itself was expanded twice during the nineteenth century.,8,0,male_masculine,8,4716
2664,780065,common_voice_en_74062.mp3,Henderson went into the railway station to telegraph the news to London.,8,0,male_masculine,8,4608
2665,898228,common_voice_en_37811148.mp3,"Pasquale wrote the musical stage version of ""Rentaghost"" with his tour manager Ray Tizzard.",8,0,male_masculine,8,7776
2666,125427,common_voice_en_35194000.mp3,An estimated one million people pass through the border crossing each year.,8,0,male_masculine,8,6336
2667,840632,common_voice_en_32757035.mp3,Jawahar High school is located in the block.,8,0,male_masculine,8,3852
2668,840546,common_voice_en_32755910.mp3,She is the author of numerous books and magazine articles on her specialty.,8,0,male_masculine,8,5508
2669,840580,common_voice_en_32756667.mp3,In the match Reigns would attack Otis thus making him unable to continue.,8,0,male_masculine,8,6336
2670,125426,common_voice_en_35193999.mp3,Christensen opted to retire.,8,0,male_masculine,8,3816
2671,840583,common_voice_en_32756685.mp3,It sees the passage from life to death in stages.,8,0,male_masculine,8,3960
2672,840584,common_voice_en_32756686.mp3,He joined youth academy of Ajax at the age of eight.,8,0,male_masculine,8,4248
2673,1199404,common_voice_en_37992692.mp3,This puts Rhys and Shelley's marriage under tremendous strain.,12,4,male_masculine,8,5796
2674,721157,common_voice_en_72412.mp3,Even then he hardly understood what this meant.,8,0,male_masculine,8,3072
2675,898227,common_voice_en_37811147.mp3,Gilsoft was started as a pocket money company.,8,0,male_masculine,8,5076
2676,1398763,common_voice_en_58749.mp3,What good is money to you if you're going to die?,8,0,male_masculine,8,3048
2677,840555,common_voice_en_32756033.mp3,It was conducted by Wolfgang Sawallisch.,8,0,male_masculine,8,4320
2678,721160,common_voice_en_72416.mp3,The loafers and golf caddies were used to hanging out near the railway station.,8,0,male_masculine,8,5376
2679,840545,common_voice_en_32755908.mp3,She was sold around the same year.,8,0,male_masculine,8,3060
2680,772416,common_voice_en_13389.mp3,Hundreds of observers saw the flame that night and the night after.,8,0,male_masculine,8,5112
2681,772338,common_voice_en_13310.mp3,He stood irresolute for a moment and then scrambled out of the pit.,9,1,male_masculine,8,4608
2682,840542,common_voice_en_32755902.mp3,She twice featured in the qualifying of the Brasil Open.,8,0,male_masculine,8,4716
2683,599038,common_voice_en_87543.mp3,The thought was so dreadful to him that he forgot about the heat and went forward.,8,0,male_masculine,8,5184
2684,898238,common_voice_en_37811158.mp3,In retirement he became a Non-Executive Director of Whitbread.,8,0,male_masculine,8,4896
2685,307742,common_voice_en_18359604.mp3,"You know, he is an honest man.",8,0,male_masculine,8,2976
2686,725513,common_voice_en_48475.mp3,"It was, however, still so hot from its flight through the air.",8,0,male_masculine,8,4896
2687,898237,common_voice_en_37811157.mp3,They contested on three Lok Sabha seat but failed to win any seats.,8,0,male_masculine,8,5400
2688,599024,common_voice_en_87529.mp3,But they were not there.,8,0,male_masculine,8,2304
2689,898236,common_voice_en_37811156.mp3,Another example of a coset comes from the theory of vector spaces.,8,0,male_masculine,8,5508
2690,482138,common_voice_en_36493720.mp3,Victory was always on his side when he threw it among the enemy.,8,0,male_masculine,8,4320
2691,1830588,common_voice_en_36918885.mp3,The majority of these emigrants are well-educated and middle-class.,8,0,male_masculine,8,5688
2692,125429,common_voice_en_35194002.mp3,Its faculty holds at least a master's degree and a number with PhDs.,8,0,male_masculine,8,6228
2693,721119,common_voice_en_72368.mp3,"I pointed out Mars, a bright dot of light.",8,0,male_masculine,8,3264
2694,898232,common_voice_en_37811152.mp3,Part of disused cars were sold to other cities in Japan.,8,0,male_masculine,8,5688
2695,444492,common_voice_en_17698668.mp3,Is it raining right now?,8,0,male_masculine,8,2184
2696,725534,common_voice_en_48497.mp3,I was disappointed at this inanimate bulk.,8,0,male_masculine,8,4776
2697,853013,common_voice_en_30644228.mp3,The Chief Justice of Ghana currently in office is the chairperson for the Council.,8,0,male_masculine,8,5796
2698,1354478,common_voice_en_39396884.mp3,Large skins full of milk are sent to the spot from neighboring villages.,8,0,male_masculine,8,5544
2699,898231,common_voice_en_37811151.mp3,"The defeat cost Mustafa his position, and ultimately, his life.",8,0,male_masculine,8,5436
2700,1090735,common_voice_en_32566317.mp3,All rounds are held in Argentina.,8,0,male_masculine,8,2196
2701,898230,common_voice_en_37811150.mp3,Family Sharing also extends into apps.,8,0,male_masculine,8,5148
2702,563634,common_voice_en_17984.mp3,"In those days, very few of the people had any idea about astronomy.",11,3,male_masculine,8,6048
2703,840574,common_voice_en_32756625.mp3,He repeatedly took part in local and parliamentary elections.,8,0,male_masculine,8,4680
2704,840575,common_voice_en_32756626.mp3,He donated seventy works to begin the collection.,8,0,male_masculine,8,4212
2705,580743,common_voice_en_69199.mp3,Replace the Ts in Tim Tebow's name with any other consonant to get a Star Wars character,8,0,male_masculine,8,5040
2706,759971,common_voice_en_16605.mp3,Then the thing came upon him in a flash.,8,0,male_masculine,8,3240
2707,840614,common_voice_en_32757006.mp3,The nearest primary schools are in Kilcoy and Mount Mee.,8,0,male_masculine,8,4968
2708,840615,common_voice_en_32757008.mp3,The mythology of ancient Meitei concerns study of cosmology as well as human body.,8,0,male_masculine,8,6444
2709,840617,common_voice_en_32757010.mp3,The city prospered during the Caliphal era.,8,0,male_masculine,8,3924
2710,898220,common_voice_en_37811139.mp3,Major fishing communities include Trinity and Heart's Content.,8,0,male_masculine,8,6156
2711,840618,common_voice_en_32757011.mp3,Castiglione lies on the south rim of the larger Rembrandt basin.,8,0,male_masculine,8,5292
2712,840587,common_voice_en_32756735.mp3,"The showers associated with this kind of clouds are therefore called ""thundershowers"" or ""thunderstorms"".",8,0,male_masculine,8,7488
2713,898226,common_voice_en_37811146.mp3,The city's coat of arms dates from that period.,8,0,male_masculine,8,4896
2714,840589,common_voice_en_32756737.mp3,Some of them attended the weapons school.,8,0,male_masculine,8,3168
2715,1182400,common_voice_en_30531997.mp3,A corresponding evaluation by the Federal Constitutional Court is still pending.,8,0,male_masculine,8,6516
2716,628189,common_voice_en_11840.mp3,Based on the omens of the present.,8,0,male_masculine,8,2832
2717,840590,common_voice_en_32756766.mp3,Exhibitions are sometimes held within the building.,8,0,male_masculine,8,4068
2718,840591,common_voice_en_32756768.mp3,The eight best snowboarders from each heat qualified for the final.,8,0,male_masculine,8,4788
2719,1444258,common_voice_en_32399762.mp3,He also solved key technical problems at Panzhihua Iron and Steel and Baotou Steel.,8,0,male_masculine,8,9216
2720,840593,common_voice_en_32756785.mp3,Four of her prints are in the collection of the National Gallery of Art.,8,0,male_masculine,8,5436
2721,840594,common_voice_en_32756786.mp3,A lover to be rescued.,8,0,male_masculine,8,2664
2722,840627,common_voice_en_32757025.mp3,But as Jackson increased in size and so did the number of students.,8,0,male_masculine,8,5364
2723,840628,common_voice_en_32757026.mp3,"Todd Thibaud also contributed to ""Glimmer"".",8,0,male_masculine,8,4140
2724,840629,common_voice_en_32757031.mp3,The finding has been accepted by the American Society of Mammalogists.,8,0,male_masculine,8,5148
2725,1828336,common_voice_en_36244352.mp3,He is the head of the Europe Department of the Faculty of World Studies.,8,0,male_masculine,8,7524
2726,840558,common_voice_en_32756040.mp3,There are no known details of his parents or siblings.,8,0,male_masculine,8,4212
2727,840559,common_voice_en_32756042.mp3,Little is known about the previous distribution of this species.,8,0,male_masculine,8,4392
2728,725581,common_voice_en_48545.mp3,Hundreds of observers saw the flame that night and the night after.,8,0,male_masculine,8,4464
2729,725553,common_voice_en_48517.mp3,So how will we name all these hurricanes?,9,1,male_masculine,8,3696
2730,840560,common_voice_en_32756484.mp3,Tlobzoda is the nearest rural locality.,8,0,male_masculine,8,4248
2731,1589941,common_voice_en_18370856.mp3,Jackie Chan is a famous martial artist and actor from Hong Kong.,8,0,male_masculine,8,5760
2732,840562,common_voice_en_32756488.mp3,Twelve more books followed.,8,0,male_masculine,8,2988
2733,922824,common_voice_en_388.mp3,I'm beginning to realize that.,8,0,male_masculine,8,2904
2734,760022,common_voice_en_16656.mp3,It was only when I got this close to it that the strangeness of it was at all evident to me.,8,0,male_masculine,8,6336
2735,840596,common_voice_en_32756788.mp3,Stupid.,8,0,male_masculine,8,1800
2736,840597,common_voice_en_32756789.mp3,The couple went on to have children.,8,0,male_masculine,8,2880
2737,780043,common_voice_en_74040.mp3,"The level ground was blackened as far as one could see, and it was still giving off smoke.",8,0,male_masculine,8,5928
2738,1823952,common_voice_en_31844332.mp3,It has received widespread critical acclaim.,10,2,male_masculine,8,4968
2739,206391,common_voice_en_35664826.mp3,This body of water is Devil's Lake.,8,0,male_masculine,8,3132
2740,187867,common_voice_en_514584.mp3,Scattered groups of people were hurrying from the direction of Woking.,8,0,male_masculine,8,5880
2741,1829453,common_voice_en_36509707.mp3,Bologna was promptly incorporated as part of the province of Romagna.,8,0,male_masculine,8,6516
2742,922823,common_voice_en_387.mp3,Ellie won first prize in the spelling competition.,8,0,male_masculine,8,4752
2743,840602,common_voice_en_32756988.mp3,Wheeler had her clean metalwork from the excavations and encouraged her interest in artefacts.,8,0,male_masculine,8,7380
2744,898221,common_voice_en_37811140.mp3,Each of the six teams received either a bronze or silver placing.,8,0,male_masculine,8,5976
2745,943474,common_voice_en_32321813.mp3,A smaller peninsula further north ends at Tanners Point.,8,0,male_masculine,8,4032
2746,840571,common_voice_en_32756582.mp3,These successive court cases spanned more than fifteen years in all.,8,0,male_masculine,8,5112
2747,840572,common_voice_en_32756623.mp3,There are several nunataks rising above the shore.,8,0,male_masculine,8,4536
2748,749149,common_voice_en_18212273.mp3,"According to the predominant notion in the Vatican, condoms shouldn't be used in spite of HIV.",8,0,male_masculine,8,6456
2749,1823701,common_voice_en_31717749.mp3,It blooms between September and October producing bright yellow flowers.,12,4,male_masculine,8,6588
2750,1180114,common_voice_en_24298.mp3,"The years of research, the magic symbols, the strange words and the laboratory equipment...",9,1,male_masculine,8,6120
2751,410685,common_voice_en_35745526.mp3,Johnson engaged to supply the press with copy as it should be wanted.,8,0,male_masculine,8,5148
2752,1815398,common_voice_en_24918802.mp3,"Oh, it was lovely!",8,0,male_masculine,8,2808
2753,410683,common_voice_en_35745490.mp3,The current editor is Kenneth Zucker.,8,0,male_masculine,8,3492
2754,500482,common_voice_en_38580.mp3,"But then they wouldn't be a part of your future, the seer had said.",8,0,male_masculine,8,4512
2755,410682,common_voice_en_35745488.mp3,Such bowlers have a shorter run up so they complete their overs more quickly.,8,0,male_masculine,8,5508
2756,410681,common_voice_en_35745333.mp3,But they divorced after six months.,8,0,male_masculine,8,3420
2757,410680,common_voice_en_35745329.mp3,The variety and minstrel performers are in greatest demand,8,0,male_masculine,8,4824
2758,859127,common_voice_en_16288.mp3,Now I will drift gently off to dreamland.,10,2,male_masculine,8,3072
2759,410676,common_voice_en_35745260.mp3,"Facing five Union divisions, Bragg withdrew.",8,0,male_masculine,8,4644
2760,768302,common_voice_en_21014.mp3,The boy was also saddened; his friend was in pursuit of his destiny.,8,0,male_masculine,8,5064
2761,1182230,common_voice_en_30531432.mp3,It is situated opposite the Church of Saint Michael and All Angels.,8,0,male_masculine,8,5328
2762,1182292,common_voice_en_30531654.mp3,He was before the Commissioner of British Cameroons (United Nations trust territory) before incorporation.,8,0,male_masculine,8,9468
2763,575312,common_voice_en_32687775.mp3,He played college basketball for the Rutgers Scarlet Knights and the Oregon Ducks.,8,0,male_masculine,8,8640
2764,323508,common_voice_en_8595.mp3,That's the point at which most people give up.,8,0,male_masculine,8,4296
2765,575311,common_voice_en_32687774.mp3,It is also on the National Register of Historic Places.,8,0,male_masculine,8,5832
2766,575310,common_voice_en_32687773.mp3,The townland is located in the civil parish of Delvin.,8,0,male_masculine,8,5940
2767,1209057,common_voice_en_32330379.mp3,Mister Md.,8,0,male_masculine,8,2880
2768,1182231,common_voice_en_30531433.mp3,There are numerous closely parallel obscure nerves.,8,0,male_masculine,8,6588
2769,773864,common_voice_en_172788.mp3,"I waited all afternoon and evening, he said.",8,0,male_masculine,8,5040
2770,575308,common_voice_en_32687267.mp3,The statue is in bronze.,8,0,male_masculine,8,3708
2771,575319,common_voice_en_32687801.mp3,News sources use their transcripts and statistics.,8,0,male_masculine,8,5796
2772,1699264,common_voice_en_26723106.mp3,The Pale of Settlement included the following areas.,8,0,male_masculine,8,5220
2773,491884,common_voice_en_36717.mp3,"You don't have to be rich, skinny, popular, or even own a cape to perform a random act of kindness.",8,0,male_masculine,8,7008
2774,992051,common_voice_en_149553.mp3,"My wife pointed out to me the brightness of the red, green, and yellow signal lights.",8,0,male_masculine,8,4680
2775,323512,common_voice_en_8599.mp3,Some men were smoking from a gigantic pipe that they passed from one to the other.,8,0,male_masculine,8,6096
2776,575322,common_voice_en_32687961.mp3,It was one of the publications of the Congress for Cultural Freedom.,8,0,male_masculine,8,5076
2777,1157909,common_voice_en_44869.mp3,"At that time, it was quite clear in my own mind that the thing had come from the planet Mars.",8,0,male_masculine,8,3984
2778,1825138,common_voice_en_32246095.mp3,The main staple foods are wheat and rice.,8,0,male_masculine,8,4428
2779,1180134,common_voice_en_24318.mp3,"The alchemist stopped abruptly, and bent to the ground.",8,0,male_masculine,8,4104
2780,1180135,common_voice_en_24319.mp3,Even though the sheep didn't teach me to speak Arabic.,10,2,male_masculine,8,3576
2781,850756,common_voice_en_30543641.mp3,Justice Kavanaugh also concurred.,12,4,male_masculine,8,3348
2782,410687,common_voice_en_35745529.mp3,"At first, the new consortium intended to produce one long-range and one short-range version.",8,0,male_masculine,8,6624
2783,575321,common_voice_en_32687959.mp3,She remained poorly at her sixties.,8,0,male_masculine,8,4140
2784,992072,common_voice_en_149574.mp3,I was impatient to see it opened.,8,0,male_masculine,8,3264
2785,1701924,common_voice_en_30401253.mp3,The size of the militia was increased as the war continued.,8,0,male_masculine,8,6228
2786,449597,common_voice_en_32547324.mp3,They are currently members of the and play at Mountbatten Park.,8,0,male_masculine,8,5616
2787,1825151,common_voice_en_32246111.mp3,Alliance Party leader Naomi Long was appointed justice minister.,8,0,male_masculine,8,5256
2788,575320,common_voice_en_32687957.mp3,She is Chair of the Cancer Prevention and Control Committee.,8,0,male_masculine,8,5256
2789,323511,common_voice_en_8598.mp3,"There's one that says, 'Everything that happens once can never happen again.",8,0,male_masculine,8,5184
2790,1182229,common_voice_en_30531431.mp3,The first ships built in the Netherlands were built by the Rijkswerf Amsterdam.,8,0,male_masculine,8,8136
2791,338476,common_voice_en_41180.mp3,Its lower end was still embedded.,8,0,male_masculine,8,3000
2792,1025438,common_voice_en_20282787.mp3,The Progressive Conservatives appealed the results to the Court of Appeal of Alberta.,8,0,male_masculine,8,7560
2793,1182293,common_voice_en_30531670.mp3,Michele represented the Adriatic renaissance.,8,0,male_masculine,8,5436
2794,575304,common_voice_en_32686803.mp3,Their partnership leads to many problems for him.,8,0,male_masculine,8,4068
2795,1516770,common_voice_en_18199000.mp3,The Canadian people are a little too humble.,8,0,male_masculine,8,4176
2796,1703741,common_voice_en_31481777.mp3,Atencio spent fifteen years in the United States Navy.,8,0,male_masculine,8,5760
2797,1398083,common_voice_en_58051.mp3,"Because I've always heard about them, the boy answered, saying nothing about his dream.",8,0,male_masculine,8,4944
2798,1182285,common_voice_en_30531642.mp3,It is today part of the collections of the Swedish History Museum.,8,0,male_masculine,8,6516
2799,1182233,common_voice_en_30531435.mp3,The Lateran account in Cod.,8,0,male_masculine,8,4176
2800,1182234,common_voice_en_30531436.mp3,They were held on the same day as other local elections.,8,0,male_masculine,8,4680
2801,1199618,common_voice_en_38013881.mp3,"Exercising prostitution without registering was charged as ""trafficking in sex"" without registration.",8,0,male_masculine,8,7200
2802,255246,common_voice_en_32641012.mp3,Moffitt previously served as the Undersecretary at the California Department of Food and Agriculture.,8,0,male_masculine,8,7344
2803,259568,common_voice_en_20286150.mp3,"On this income, Parque's parents struggled to provide for Parque and his brother.",8,0,male_masculine,8,7200
2804,768275,common_voice_en_20987.mp3,"Before long, maybe in just a few days, he would be at the Pyramids.",8,0,male_masculine,8,5040
2805,777770,common_voice_en_115455.mp3,"Well then, why did you let me do it? the boy asked.",8,0,male_masculine,8,3456
2806,1180178,common_voice_en_24366.mp3,I went stretching my legs clumsily and feeling my way in the dark.,8,0,male_masculine,8,3936
2807,58203,common_voice_en_32929052.mp3,She is the first woman to hold this professorship.,8,0,male_masculine,8,5076
2808,590728,common_voice_en_35517.mp3,But everything had changed.,9,1,male_masculine,8,1824
2809,1822139,common_voice_en_30667771.mp3,He gets along with Mckenna Grace.,10,2,male_masculine,8,4680
2810,1182238,common_voice_en_30531440.mp3,The company cooperates with international financial institutions.,8,0,male_masculine,8,5400
2811,1823807,common_voice_en_31732870.mp3,This was by far the match of the night.,10,2,male_masculine,8,4068
2812,491863,common_voice_en_36696.mp3,"The heather was on fire, and you could see a thin blue smoke rising up slowly.",8,0,male_masculine,8,5712
2813,1025462,common_voice_en_20283055.mp3,Banda became President of Malawi as the post of prime minister was abolished.,9,1,male_masculine,8,7392
2814,1182240,common_voice_en_30531447.mp3,Wedding rings are visible on their hands.,8,0,male_masculine,8,5076
2815,1182235,common_voice_en_30531437.mp3,It is never made clear who set it.,8,0,male_masculine,8,3600
2816,1316500,common_voice_en_20286311.mp3,The episode is titled Sacrificial Evil.,8,0,male_masculine,8,4752
2817,1398051,common_voice_en_58019.mp3,"And yet, none of these people has ever met the old king.",8,0,male_masculine,8,3312
2818,1157886,common_voice_en_44845.mp3,"Why the shots stopped after the tenth, no one on earth has tried to explain.",8,0,male_masculine,8,3456
2819,575307,common_voice_en_32687266.mp3,He worked in the Office of Foreign Affairs.,8,0,male_masculine,8,4500
2820,323505,common_voice_en_8592.mp3,Others stumbled upon the stone by accident.,8,0,male_masculine,8,3744
2821,577331,common_voice_en_42015.mp3,Everyone seemed very excited.,8,0,male_masculine,8,4392
2822,575306,common_voice_en_32687263.mp3,He credited his education for preparing him to play Japanese roles.,8,0,male_masculine,8,6480
2823,859131,common_voice_en_16292.mp3,And he wasn't faring much better.,8,0,male_masculine,8,2424
2824,338477,common_voice_en_41181.mp3,It spread through the planet's atmosphere and obscured its more familiar features.,8,0,male_masculine,8,4824
2825,1182288,common_voice_en_30531650.mp3,He was an Great Britain and England international and ran long distance races.,8,0,male_masculine,8,8208
2826,575305,common_voice_en_32686804.mp3,One solution is the effective use of local staff.,8,0,male_masculine,8,5076
2827,138739,common_voice_en_118578.mp3,I thought the unscrewing might be automatic.,8,0,male_masculine,8,3336
2828,1182287,common_voice_en_30531644.mp3,It did at one time.,8,0,male_masculine,8,4176
2829,1157863,common_voice_en_44822.mp3,I found a little crowd of about twenty people surrounding the huge hole.,8,0,male_masculine,8,3264
2830,1180133,common_voice_en_24317.mp3,"He had used the two stones only once, one morning when he was at a marketplace.",8,0,male_masculine,8,4968
2831,595332,common_voice_en_17849819.mp3,You may whistle for it.,8,0,male_masculine,8,3024
2832,1022626,common_voice_en_74632.mp3,"It was seen early in the morning, rushing over eastward.",8,0,male_masculine,8,4008
2833,1436469,common_voice_en_33106329.mp3,They lost to South Dakota State in the quarterfinals of the Summit League Tournament.,8,0,male_masculine,8,6768
2834,1398043,common_voice_en_58010.mp3,The boy was suddenly happy to be there at the warehouse.,8,0,male_masculine,8,3384
2835,1182286,common_voice_en_30531643.mp3,Data is split into chunks.,8,0,male_masculine,8,4968
2836,1157826,common_voice_en_44785.mp3,There were lights in the upper windows of the houses when the people went to bed.,9,1,male_masculine,8,2856
2837,1398032,common_voice_en_57999.mp3,It turned out to be a bitter tea.,8,0,male_masculine,8,2592
2838,1368630,common_voice_en_35276032.mp3,There are no teams and the hurl follows a set route.,8,0,male_masculine,8,3816
2839,1182312,common_voice_en_30531779.mp3,Abercromby owned the lands of the parish Abercrombie in Fife.,8,0,male_masculine,8,6948
2840,1182226,common_voice_en_30531428.mp3,The registration has been subject to various conspiracy theories.,8,0,male_masculine,8,6768
2841,548317,common_voice_en_20641.mp3,or a man into the wind.,8,0,male_masculine,8,3144
2842,1182311,common_voice_en_30531778.mp3,It is the headquarters of Cambridgeshire County Council.,8,0,male_masculine,8,4428
2843,1182310,common_voice_en_30531777.mp3,Flowering occurs from July to November.,8,0,male_masculine,8,5436
2844,652131,common_voice_en_34851.mp3,That's what alchemists do.,8,0,male_masculine,8,2856
2845,1182309,common_voice_en_30531776.mp3,Yamamoto not only helped produce the show but helped make the game footage.,8,0,male_masculine,8,5940
2846,1182308,common_voice_en_30531775.mp3,He is Minister for the interior in the Free Hanseatic City of Bremen.,8,0,male_masculine,8,6336
2847,1821416,common_voice_en_30398154.mp3,The Ottoman Sultan gave him the title of Amir.,8,0,male_masculine,8,4716
2848,56303,common_voice_en_36905612.mp3,The honor of reigning is very frequently rejected in Africa.,8,0,male_masculine,8,7956
2849,1182307,common_voice_en_30531749.mp3,He was again member of the campaign team and of the election program committee.,8,0,male_masculine,8,7380
2850,575326,common_voice_en_32688012.mp3,Trud is the nearest rural locality.,8,0,male_masculine,8,5220
2851,859121,common_voice_en_16282.mp3,Most meteorites are more or less rounded.,9,1,male_masculine,8,2856
2852,768287,common_voice_en_20999.mp3,It was the first time either had touched the other.,8,0,male_masculine,8,3504
2853,361087,common_voice_en_114900.mp3,There was very little talking.,8,0,male_masculine,8,3600
2854,478384,common_voice_en_20284683.mp3,He is currently serving on the Editorial Board of the journal Neuroscience of Consciousness.,9,1,male_masculine,8,9432
2855,1160356,common_voice_en_17585478.mp3,Will no one go?,10,2,male_masculine,8,1536
2856,474319,common_voice_en_20284551.mp3,It is officially known as Downtown DeLand Historic District.,9,1,male_masculine,8,6288
2857,1182306,common_voice_en_30531748.mp3,Discrimination is unjust or prejudicial treatment of different categories of people or things.,8,0,male_masculine,8,7236
2858,548298,common_voice_en_20621.mp3,"I'm doing much better, and soon you'll be able to return to your sheep.",8,0,male_masculine,8,5304
2859,769424,common_voice_en_530513.mp3,"As I watched, the planet seemed to grow larger and smaller.",8,0,male_masculine,8,4080
2860,1182316,common_voice_en_30531803.mp3,His characters live and resound.,8,0,male_masculine,8,3780
2861,768299,common_voice_en_21011.mp3,"I still have no idea how to turn myself into the wind, the boy repeated.",8,0,male_masculine,8,4992
2862,530497,common_voice_en_7876.mp3,"I learned how to care for sheep, and I haven't forgotten how that's done.",10,2,male_masculine,8,7776
2863,957073,common_voice_en_37665985.mp3,"According to Clark, Bogart gave him his stage name.",8,0,male_masculine,8,4248
2864,1182315,common_voice_en_30531802.mp3,There were other collapses after this.,8,0,male_masculine,8,3816
2865,575328,common_voice_en_32688014.mp3,Similar projects are under way in Alexandria.,8,0,male_masculine,8,4320
2866,504947,common_voice_en_90118.mp3,The guy thought he was a lunatic at large and made an unsuccessful attempt to stop him.,10,2,male_masculine,8,5352
2867,1182314,common_voice_en_30531801.mp3,The official music video exclusively premiered on Cosmopolitan the next day.,8,0,male_masculine,8,6588
2868,901967,common_voice_en_106782.mp3,"And yet, none of these people has ever met the old king.",8,0,male_masculine,8,4224
2869,859104,common_voice_en_16265.mp3,Few people realise the immensity of vacancy.,8,0,male_masculine,8,3024
2870,478405,common_voice_en_20284765.mp3,Dental amalgam used in fillings inhibits bacterial reproduction.,9,1,male_masculine,8,7824
2871,1182225,common_voice_en_30531427.mp3,He returned to New Brunswick upon acceptance to the University of New Brunswick.,8,0,male_masculine,8,6336
2872,991933,common_voice_en_149433.mp3,But they were not there.,8,0,male_masculine,8,1872
2873,504952,common_voice_en_90123.mp3,He had seen the shooting star and was persuaded that a meteorite lay somewhere nearby.,8,0,male_masculine,8,5904
2874,906443,common_voice_en_489998.mp3,"So, then try, he said to the Englishman.",8,0,male_masculine,8,5136
2875,1182313,common_voice_en_30531800.mp3,Its workload continued to grow as its competencies were expanded.,8,0,male_masculine,8,6408
2876,548308,common_voice_en_20632.mp3,I'm going to hate those who have found their treasure because I never found mine.,8,0,male_masculine,8,6480
2877,1080235,common_voice_en_35034778.mp3,"Also, no photos appear to have survived, even in his family.",8,0,male_masculine,8,5328
2878,859108,common_voice_en_16269.mp3,They set off running wildly into the trees.,8,0,male_masculine,8,3024
2879,575327,common_voice_en_32688013.mp3,The composition was released on Juno Download for free.,8,0,male_masculine,8,5004
2880,1822713,common_voice_en_31169040.mp3,She succeeded her husband Tom Carter.,8,0,male_masculine,8,4320
2881,1182224,common_voice_en_30531426.mp3,Its administrative centre was Orsha.,8,0,male_masculine,8,4248
2882,1180106,common_voice_en_24290.mp3,"Are you crazy? the boy asked the alchemist, when they had moved on.",8,0,male_masculine,8,4752
2883,859139,common_voice_en_16300.mp3,"When he saw Henderson in his garden, he called over the fence and made himself understood.",8,0,male_masculine,8,6576
2884,1182302,common_voice_en_30531699.mp3,This meant tournaments that were ongoing or have not been started were all canceled.,8,0,male_masculine,8,6336
2885,467685,common_voice_en_37345850.mp3,The flowers are arranged in leaf axils in clusters of eight to sixteen.,8,0,male_masculine,8,6336
2886,239938,common_voice_en_30608694.mp3,His sophomore season was cut short after he broke his arm.,8,0,male_masculine,8,5148
2887,1182299,common_voice_en_30531696.mp3,He visited various parts of Kerala and converted the natives including Namboothiri.,8,0,male_masculine,8,7668
2888,1182298,common_voice_en_30531695.mp3,Many of the Palestinians in Lebanon were also fluent in the language.,8,0,male_masculine,8,6300
2889,1182228,common_voice_en_30531430.mp3,For group play the teams were divided into the Steel and Maple groups.,8,0,male_masculine,8,6408
2890,593341,common_voice_en_17484120.mp3,"I've really started to appreciate Imperial measurements, you could say I'm a convert.",8,0,male_masculine,8,6384
2891,1182297,common_voice_en_30531674.mp3,Mean monthly temperatures range from in January.,8,0,male_masculine,8,5796
2892,575325,common_voice_en_32688010.mp3,"She participated in the dance survival show ""Hit the Stage"".",8,0,male_masculine,8,6264
2893,1182296,common_voice_en_30531673.mp3,Sisterhood.,8,0,male_masculine,8,3240
2894,859115,common_voice_en_16276.mp3,I wished I had a light to smoke by.,8,0,male_masculine,8,3144
2895,453453,common_voice_en_10664.mp3,"The shop folks were taking down their shutters, and people were opening their bedroom windows.",10,2,male_masculine,8,4728
2896,1316507,common_voice_en_20286333.mp3,"Unsurprisingly, Nakano struggled in the under-powered, under-financed Italian team.",8,0,male_masculine,8,7992
2897,859152,common_voice_en_16313.mp3,There was very little talking.,9,1,male_masculine,8,2904
2898,856021,common_voice_en_30536652.mp3,The judge subsequently fled the country.,8,0,male_masculine,8,4176
2899,575323,common_voice_en_32687962.mp3,The album was certified platinum by the Korean Music Content Association.,8,0,male_masculine,8,6948
2900,1182294,common_voice_en_30531671.mp3,One important commodity it produced was coal.,8,0,male_masculine,8,5220
2901,768245,common_voice_en_20957.mp3,The alchemist told the boy to place the shell over his ear.,10,2,male_masculine,8,4320
2902,491886,common_voice_en_36719.mp3,"When I returned to the common, the sun was setting.",8,0,male_masculine,8,3072
2903,992035,common_voice_en_149537.mp3,The guy thought he was a lunatic at large and made an unsuccessful attempt to stop him.,8,0,male_masculine,8,5184
2904,338463,common_voice_en_54506.mp3,He saw that Fatima's eyes were filled with tears.,11,3,male_masculine,8,5424
2905,992004,common_voice_en_149505.mp3,I locked eyes with a fish in the tank.,8,0,male_masculine,8,2688
2906,1821420,common_voice_en_30398163.mp3,He was survived by his wife and several children.,8,0,male_masculine,8,4536
2907,1456043,common_voice_en_35243460.mp3,The main cargoes were coal and stone.,8,0,male_masculine,8,4392
2908,1182305,common_voice_en_30531747.mp3,Now people are trying to hunt him down.,8,0,male_masculine,8,3780
2909,1180063,common_voice_en_24247.mp3,"Maybe we're all that way, the boy mused.",11,3,male_masculine,8,3432
2910,530474,common_voice_en_7852.mp3,Maybe she didn't even remember him.,8,0,male_masculine,8,6504
2911,859134,common_voice_en_16295.mp3,"At the first glance, it was really not very exciting.",8,0,male_masculine,8,3864
2912,768251,common_voice_en_20963.mp3,It was the first time she had done that.,8,0,male_masculine,8,2760
2913,459267,common_voice_en_17525.mp3,"As the Englishman left, Fatima arrived and filled her vessel with water.",8,0,male_masculine,8,6456
2914,1815324,common_voice_en_24918560.mp3,The show is also famous for its catchy theme music written by Hachidai Nakamura.,8,0,male_masculine,8,8820
2915,241198,common_voice_en_30336667.mp3,Nichols has five children.,8,0,male_masculine,8,3240
2916,768250,common_voice_en_20962.mp3,The meeting was over.,8,0,male_masculine,8,2544
2917,1157922,common_voice_en_44883.mp3,"Before guns were invented, armies had to throw bullets at each other and if a bullet touched you, you had to sit out until the next war.",8,0,male_masculine,8,6024
2918,1182304,common_voice_en_30531746.mp3,Skovoroda Kharkiv National Pedagogical University (mathematics).,8,0,male_masculine,8,7236
2919,992016,common_voice_en_149518.mp3,"Air was either entering or escaping at the rim with a thin, sizzling sound.",8,0,male_masculine,8,4824
2920,575324,common_voice_en_32687964.mp3,"And then he directed and acted in ""Nin Lo Chin Tha Lo"" music video.",8,0,male_masculine,8,9072
2921,1182303,common_voice_en_30531745.mp3,David is in natural possession of the wallet.,8,0,male_masculine,8,4860
2922,1357086,common_voice_en_32417099.mp3,The songs upon release garnered positive reviews and topped the musical charts.,8,0,male_masculine,8,6732
2923,593320,common_voice_en_17304452.mp3,"Well, the merry-go-round wasn't exactly spectacular.",8,0,male_masculine,8,4728
2924,1750072,common_voice_en_38553007.mp3,His riding of Mayo had been amalgamated with the neighbouring riding of Tatchun.,8,0,male_masculine,8,7236
2925,1823373,common_voice_en_31469149.mp3,He was not able to attend his Melbourne Cup victory due to ill health.,8,0,male_masculine,8,6156
2926,1182227,common_voice_en_30531429.mp3,The subject was the eruption of uncertainty in the hard sciences and the humanities.,8,0,male_masculine,8,7920
2927,1182259,common_voice_en_30531555.mp3,He is the former head of the Defense Intelligence Service.,8,0,male_masculine,8,4356
2928,1182275,common_voice_en_30531603.mp3,She won six of her eight Federation Cup doubles rubbers.,8,0,male_masculine,8,5076
2929,820380,common_voice_en_109535.mp3,Many telescopes were pointed at it.,8,0,male_masculine,8,3144
2930,1182260,common_voice_en_30531556.mp3,Newest physical field reduction solutions were applied too.,8,0,male_masculine,8,5508
2931,820381,common_voice_en_109536.mp3,"Then he dropped his spade, picked up his jacket, and came out into the road.",8,0,male_masculine,8,6480
2932,1182262,common_voice_en_30531559.mp3,The base has been turned over to farmland.,8,0,male_masculine,8,3888
2933,1182274,common_voice_en_30531602.mp3,This would lead to Havok defeating Nevaeh and Nevaeh leaving Impact shortly after.,8,0,male_masculine,8,7200
2934,859203,common_voice_en_32174934.mp3,Reinforcements finally arrived in the form of Wang Mi.,8,0,male_masculine,8,4968
2935,594907,common_voice_en_41666.mp3,"It was seen early in the morning, rushing over eastward.",9,1,male_masculine,8,6216
2936,594905,common_voice_en_41664.mp3,"When he saw Henderson in his garden, he called over the fence and made himself understood.",8,0,male_masculine,8,9000
2937,575302,common_voice_en_32686799.mp3,Winter storms had cancelled the sale of his farm.,8,0,male_masculine,8,4608
2938,365266,common_voice_en_134008.mp3,There was very little talking.,8,0,male_masculine,8,5184
2939,1278426,common_voice_en_20285608.mp3,The work ends with a brief consideration of the word 'have' and its usage.,8,0,male_masculine,8,7344
2940,1180255,common_voice_en_24443.mp3,There was enough there to buy a lot of weapons.,8,0,male_masculine,8,3744
2941,1157792,common_voice_en_44749.mp3,I think they perceived that nothing was to be done at the moment.,9,1,male_masculine,8,2784
2942,500473,common_voice_en_38570.mp3,"It's easy, and yet I've never done it before, he thought.",8,0,male_masculine,8,4104
2943,458638,common_voice_en_32838826.mp3,He worked as an assistant doctor at the Rorschach Hospital.,8,0,male_masculine,8,6696
2944,594896,common_voice_en_41655.mp3,It seemed so safe and tranquil.,9,1,male_masculine,8,6264
2945,1278419,common_voice_en_20285569.mp3,It's being alive.,8,0,male_masculine,8,3792
2946,354049,common_voice_en_35294.mp3,Even then he hardly understood what this meant.,8,0,male_masculine,8,4272
2947,1278418,common_voice_en_20285525.mp3,This site is on a small island on the peak of Musandam Peninsula.,8,0,male_masculine,8,6552
2948,567155,common_voice_en_33428622.mp3,He is sophisticated but nerdy.,8,0,male_masculine,8,3600
2949,1182281,common_voice_en_30531623.mp3,Today these Proterozoic rocks form Fitzpatrick Peak to the east of the pass.,8,0,male_masculine,8,8208
2950,451572,common_voice_en_17035.mp3,"Everything in life is an omen, said the Englishman, now closing the journal he was reading.",8,0,male_masculine,8,5400
2951,1182280,common_voice_en_30531622.mp3,Ten grey brownish blotches runs along the tail.,8,0,male_masculine,8,5220
2952,1180301,common_voice_en_24490.mp3,"Looking at the sun, he calculated that he would reach Tarifa before midday.",8,0,male_masculine,8,5112
2953,820374,common_voice_en_109529.mp3,I'm trying to explain to my mother how to get pictures off her phone.,8,0,male_masculine,8,4560
2954,697913,common_voice_en_38969856.mp3,The team was led on offense by running back Archie Amerson.,8,0,male_masculine,8,5220
2955,1804628,common_voice_en_23349571.mp3,Prisoners who committed petty crimes were held with murderers.,8,0,male_masculine,8,6648
2956,458636,common_voice_en_32838824.mp3,West decides to pass.,8,0,male_masculine,8,4248
2957,859162,common_voice_en_16323.mp3,"Besides that, there was a heap of bicycles.",9,1,male_masculine,8,3240
2958,652117,common_voice_en_34837.mp3,"I'm an alchemist simply because I'm an alchemist, he said, as he prepared the meal.",8,0,male_masculine,8,6144
2959,1182276,common_voice_en_30531604.mp3,He worked to help the first industry standards for videocassettes and discs.,8,0,male_masculine,8,6120
2960,458637,common_voice_en_32838825.mp3,"Kesha discourses about her absent father in ""Father Daughter Dance"".",8,0,male_masculine,8,7740
2961,1182278,common_voice_en_30531620.mp3,This bossiaea grows in woodland and forest between Bundaberg and Townsville in eastern Queensland.,8,0,male_masculine,8,8496
2962,239933,common_voice_en_30608684.mp3,Her dissertation considered whether the right questions were being asked about academy education trusts.,16,8,male_masculine,8,9108
2963,1068191,common_voice_en_32395413.mp3,The entire film was shot in different parts of Goa.,8,0,male_masculine,8,4068
2964,1180248,common_voice_en_24436.mp3,The guy thought he was a lunatic at large and made an unsuccessful attempt to stop him.,8,0,male_masculine,8,5040
2965,1182277,common_voice_en_30531605.mp3,Thanks to the sport of soccer Osorio found his vocation in music.,8,0,male_masculine,8,6048
2966,1068192,common_voice_en_32395414.mp3,The wheelhouse has good headroom and contains the navigation station.,8,0,male_masculine,8,5148
2967,1251191,common_voice_en_35056968.mp3,The Sydney Kings' first home venue was the State Sports Centre located at Homebush.,8,0,male_masculine,8,6192
2968,1182258,common_voice_en_30531553.mp3,The paper was eventually published twice per week.,8,0,male_masculine,8,6156
2969,476771,common_voice_en_110870.mp3,That sobered him a little.,8,0,male_masculine,8,3672
2970,451585,common_voice_en_17048.mp3,"Life attracts life, the alchemist answered.",9,1,male_masculine,8,3672
2971,820448,common_voice_en_109604.mp3,Even then he hardly understood what this meant.,8,0,male_masculine,8,3600
2972,458641,common_voice_en_32838835.mp3,The square is triangular in shape.,8,0,male_masculine,8,4608
2973,1182270,common_voice_en_30531588.mp3,Harris married Lynne Purdy Harris.,8,0,male_masculine,8,3960
2974,1398270,common_voice_en_58244.mp3,"It's the other foreigner, the Englishman.",8,0,male_masculine,8,2640
2975,458623,common_voice_en_32838806.mp3,"He would later admit to ""chatting"" with the corpses while drowning them.",8,0,male_masculine,8,6552
2976,820409,common_voice_en_109564.mp3,Few people realise the immensity of vacancy.,8,0,male_masculine,8,3912
2977,1809997,common_voice_en_24010495.mp3,"In Japan, it was sold at Toyota Japanese dealerships called ""Toyopet Store"".",8,0,male_masculine,8,7308
2978,304940,common_voice_en_67943.mp3,"My seven year resume gap is marked ""Not Drugs"".",9,1,male_masculine,8,4056
2979,1182269,common_voice_en_30531587.mp3,It became an Act following Royal Assent.,8,0,male_masculine,8,4068
2980,820414,common_voice_en_109570.mp3,He noticed the unequal cooling of its surface.,8,0,male_masculine,8,3624
2981,357285,common_voice_en_13757.mp3,"Looking up, he saw a pair of hawks flying high in the sky.",9,1,male_masculine,8,6264
2982,1180269,common_voice_en_24457.mp3,The burning fire had been extinguished.,8,0,male_masculine,8,2880
2983,452126,common_voice_en_91143.mp3,"Air was either entering or escaping at the rim with a thin, sizzling sound.",8,0,male_masculine,8,6912
2984,452129,common_voice_en_91146.mp3,Most of them were staring quietly at the big table.,9,1,male_masculine,8,4944
2985,1705698,common_voice_en_38233241.mp3,No record exists of her birth date.,8,0,male_masculine,8,4428
2986,1821380,common_voice_en_30347125.mp3,The district around Huntington Creek is occupied with mining.,8,0,male_masculine,8,6372
2987,1436852,common_voice_en_33642859.mp3,He played college basketball for the Southeast Missouri State Redhawks.,8,0,male_masculine,8,6516
2988,343054,common_voice_en_112479.mp3,"There were raised voices,and some sort of struggle appeared to be going on. .",8,0,male_masculine,8,6840
2989,1703677,common_voice_en_31438445.mp3,Both rivers are tributaries of the Jordan River.,8,0,male_masculine,8,4716
2990,820419,common_voice_en_109575.mp3,I wished I had a light to smoke by.,9,1,male_masculine,8,2496
2991,1155518,common_voice_en_22016694.mp3,no,8,0,male_masculine,8,3408
2992,290400,common_voice_en_41728.mp3,The Englishman was disappointed.,8,0,male_masculine,8,3120
2993,1278416,common_voice_en_20285521.mp3,"The case is known as ""Winters versus United States"".",8,0,male_masculine,8,5568
2994,1705872,common_voice_en_38235329.mp3,Erdmann was born in Bonn.,8,0,male_masculine,8,4212
2995,1180261,common_voice_en_24449.mp3,The boy felt ill and terribly alone.,8,0,male_masculine,8,3264
2996,820459,common_voice_en_109615.mp3,He got up early with the idea of finding it.,8,0,male_masculine,8,2904
2997,199691,common_voice_en_37892998.mp3,"They had three children: Thomas, Virginia, and Hopkins Lacey.",8,0,male_masculine,8,5328
2998,1398212,common_voice_en_58185.mp3,But in his heart he knew that it did matter.,8,0,male_masculine,8,2640
2999,357291,common_voice_en_13764.mp3,"To do that successfully, I must have no fear of failure.",8,0,male_masculine,8,4824
3000,1182265,common_voice_en_30531568.mp3,He is also the chairman of the United Nations Internal controls Advisory Committee.,8,0,male_masculine,8,7128
3001,1789667,common_voice_en_20836714.mp3,"This was the world's first regular ""high-definition"" television service.",8,0,male_masculine,8,7200
3002,594878,common_voice_en_41637.mp3,I found a little crowd of about twenty people surrounding the huge hole.,8,0,male_masculine,8,6384
3003,1157819,common_voice_en_44778.mp3,"If you start your emails with ""Greetings"" let me be the first to welcome you to Earth.",9,1,male_masculine,8,4056
3004,1182273,common_voice_en_30531601.mp3,Its structure proved to be more difficult to describe within the initial approach.,8,0,male_masculine,8,6660
3005,458640,common_voice_en_32838834.mp3,The Cameroonian Army claimed that no civilians had been killed during the fighting.,8,0,male_masculine,8,6516
3006,1705816,common_voice_en_38235234.mp3,"Distraught, he produces a gun and threatens to kill himself.",8,0,male_masculine,8,4680
3007,1182266,common_voice_en_30531569.mp3,The accuracy is however typically not sufficient for meaningful contact tracing.,8,0,male_masculine,8,6768
3008,1182272,common_voice_en_30531590.mp3,During this period he collaborated with future Nobel laureate George Smoot.,8,0,male_masculine,8,8928
3009,1182271,common_voice_en_30531589.mp3,Morgan attended the University of North Dakota.,8,0,male_masculine,8,5328
3010,1182267,common_voice_en_30531570.mp3,The poet Ambroise records the moving reunion of father and daughter in captivity.,8,0,male_masculine,8,7128
3011,546819,common_voice_en_37289632.mp3,It stayed on top for four consecutive weeks.,8,0,male_masculine,8,4140
3012,1157821,common_voice_en_44780.mp3,"I was scared, but wasted no time in going out and crossing the bridge to the sand pits.",8,0,male_masculine,8,3936
3013,1080102,common_voice_en_35012400.mp3,This is a festival of popular music.,8,0,male_masculine,8,3060
3014,1183285,common_voice_en_25635985.mp3,Bowen's work has often focused on the ecology of fisheries.,8,0,male_masculine,8,4320
3015,861507,common_voice_en_19509.mp3,And the sand and gravel had been flung violently in every direction.,8,0,male_masculine,8,7296
3016,692613,common_voice_en_678701.mp3,"Some went away while I was there, and other people came.",8,0,male_masculine,8,4536
3017,575292,common_voice_en_32686663.mp3,She was also an active campaigner in the peace movements in Belfast.,8,0,male_masculine,8,6696
3018,761420,common_voice_en_37268512.mp3,"The complex includes a number of shops, cafes and restaurants, and two office towers.",10,2,male_masculine,8,6408
3019,331574,common_voice_en_32780.mp3,"He did find it, soon after dawn, and not far from the sand pits.",8,0,male_masculine,8,4824
3020,1182248,common_voice_en_30531461.mp3,And suddenly the former classmates gather there and the meeting reinforces their old feelings.,8,0,male_masculine,8,8316
3021,1182249,common_voice_en_30531462.mp3,Not Include in Any Solo Album,8,0,male_masculine,8,4788
3022,897269,common_voice_en_619437.mp3,"When I returned to the common, the sun was setting.",8,0,male_masculine,8,4560
3023,331578,common_voice_en_32784.mp3,Some of the grey ash was falling off the circular edge.,8,0,male_masculine,8,4464
3024,331579,common_voice_en_32785.mp3,Scattered groups of people were hurrying from the direction of Woking.,8,0,male_masculine,8,4656
3025,1182251,common_voice_en_30531464.mp3,They are also needed if an application for probate or administration is required.,8,0,male_masculine,8,7308
3026,1398218,common_voice_en_58192.mp3,The boy observed in silence the progress of the animals and people across the desert.,8,0,male_masculine,8,4920
3027,453201,common_voice_en_45271.mp3,I'm trying to explain to my mother how to get pictures off her phone.,8,0,male_masculine,8,5592
3028,276674,common_voice_en_32669120.mp3,The following list is of the directors of the French archaeological delegation.,8,0,male_masculine,8,7740
3029,1022534,common_voice_en_74540.mp3,But he appeared to be unaware of any danger.,8,0,male_masculine,8,2904
3030,331585,common_voice_en_32791.mp3,Strange images passed through my mind.,8,0,male_masculine,8,3504
3031,276676,common_voice_en_32669256.mp3,He was ridden in most of his races by Masayoshi Ebina.,8,0,male_masculine,8,6300
3032,1831332,common_voice_en_37204601.mp3,Reviews of the series have been mostly positive.,10,2,male_masculine,8,3960
3033,276678,common_voice_en_32669263.mp3,The high mountain.,8,0,male_masculine,8,3348
3034,458624,common_voice_en_32838812.mp3,She is the granddaughter of Abdul Majeed Khwaja and the niece of Jamal Khwaja.,8,0,male_masculine,8,8640
3035,435572,common_voice_en_37062739.mp3,"Garden: ""Here's something I wrote this morning"".",8,0,male_masculine,8,4068
3036,458625,common_voice_en_32838813.mp3,Together they became prominent artists of the Soviet and world circus.,8,0,male_masculine,8,5904
3037,276673,common_voice_en_32669116.mp3,The library is open to the public.,8,0,male_masculine,8,5256
3038,259571,common_voice_en_20286153.mp3,The organisation has also been criticised at times for being highly politicised.,8,0,male_masculine,8,7200
3039,331582,common_voice_en_32788.mp3,I heard a peculiar humming sound from the pit.,8,0,male_masculine,8,3936
3040,1183333,common_voice_en_25715401.mp3,The town of Deposit is on the western border of the county.,8,0,male_masculine,8,3780
3041,458621,common_voice_en_32838802.mp3,Lewis published both newspapers.,8,0,male_masculine,8,3816
3042,1180320,common_voice_en_24509.mp3,He paid for the wool and asked the shepherd to come back the following year.,8,0,male_masculine,8,5088
3043,490571,common_voice_en_93063.mp3,The secret is here in the present.,8,0,male_masculine,8,4608
3044,732601,common_voice_en_657572.mp3,"When he saw Henderson in his garden, he called over the fence and made himself understood.",8,0,male_masculine,8,5064
3045,1080182,common_voice_en_35034690.mp3,"He is the son and brother of singer-songwriters Bob Dylan and Jakob Dylan, respectively.",10,2,male_masculine,8,8316
3046,1821016,common_voice_en_30049882.mp3,It is sung by Shreya Ghoshal and liked by the audience.,8,0,male_masculine,8,7812
3047,1182242,common_voice_en_30531449.mp3,Thirteen former champions entered the tournament.,8,0,male_masculine,8,5328
3048,453214,common_voice_en_45284.mp3,It seemed so safe and tranquil.,8,0,male_masculine,8,3240
3049,1182243,common_voice_en_30531450.mp3,United Nations Mission in Nepal called for an unbiased examination of the incident.,8,0,male_masculine,8,7740
3050,575294,common_voice_en_32686666.mp3,"They describe themselves as ""a faithfully skeptical Christian"".",8,0,male_masculine,8,5436
3051,458622,common_voice_en_32838804.mp3,He is currently an assistant coach at Purdue.,8,0,male_masculine,8,4644
3052,1182245,common_voice_en_30531453.mp3,Flint published analyses of the phonological and grammatical features of Aboriginal English.,8,0,male_masculine,8,7128
3053,1182246,common_voice_en_30531454.mp3,He missed time during the season due to undergoing knee surgery.,8,0,male_masculine,8,6048
3054,575293,common_voice_en_32686665.mp3,White and her husband Erik Mayville have one son together and two stepdaughters.,8,0,male_masculine,8,7668
3055,1182247,common_voice_en_30531455.mp3,The two meet with Trieu at her Millennium Clock facility.,8,0,male_masculine,8,5868
3056,652130,common_voice_en_34850.mp3,The crowd swayed a little as I elbowed my way through.,8,0,male_masculine,8,4416
3057,453216,common_voice_en_45286.mp3,The greatest authority on meteorites stated that the height of its first appearance was about ninety or one hundred miles.,9,1,male_masculine,8,9264
3058,1436553,common_voice_en_33272638.mp3,Van der Wee has two children.,8,0,male_masculine,8,3960
3059,606394,common_voice_en_111002.mp3,"In spite of this, I still believed that there were men in Mars.",8,0,male_masculine,8,4800
3060,1437012,common_voice_en_31443277.mp3,De Goede also succeeded Davidson as Shadow Minister of International Relations and Cooperation.,8,0,male_masculine,8,7560
3061,1180191,common_voice_en_24379.mp3,The caravan moved toward the east.,8,0,male_masculine,8,3504
3062,289675,common_voice_en_37081610.mp3,"One of the diners is a peanut-lover, and the other is allergic to peanuts.",12,4,male_masculine,8,7236
3063,1182282,common_voice_en_30531625.mp3,He studied manufacturing engineering and operations control in Bilbao.,8,0,male_masculine,8,7308
3064,690056,common_voice_en_38127480.mp3,Winder spoke several languages including Sanskrit and Buddhist Pali.,8,0,male_masculine,8,5184
3065,172249,common_voice_en_18800.mp3,I only interpret dreams.,8,0,male_masculine,8,3696
3066,1786042,common_voice_en_20715408.mp3,The nesting of row covers and low tunnels inside high tunnels is also common.,8,0,male_masculine,8,8328
3067,214344,common_voice_en_151208.mp3,"The horseman was completely immobile, as was the boy.",8,0,male_masculine,8,4344
3068,1022510,common_voice_en_74516.mp3,"On the first day he returned with a rabbit, and on the second with two birds.",8,0,male_masculine,8,4536
3069,1022508,common_voice_en_74514.mp3,A boy came running towards me.,8,0,male_masculine,8,2664
3070,1180203,common_voice_en_24391.mp3,"There are many languages spoken by things, the boy said.",9,1,male_masculine,8,3144
3071,690076,common_voice_en_38127509.mp3,"It was written by Haruko Nagatsu, Shen Wei, and Yee Chin-yen.",10,2,male_masculine,8,6336
3072,768260,common_voice_en_20972.mp3,"He sat on a stone, and allowed himself to become hypnotized by the horizon.",8,0,male_masculine,8,5112
3073,1699714,common_voice_en_27497350.mp3,"Robert had married Wigod's daughter Ealdgyth, and ultimately inherited many of his father-in-law's lands.",8,0,male_masculine,8,9720
3074,1699720,common_voice_en_27497356.mp3,It is affiliated to the University of Calicut.,8,0,male_masculine,8,5256
3075,453077,common_voice_en_45191.mp3,I have the diet of a kid who found twenty dollars.,10,2,male_masculine,8,2688
3076,423291,common_voice_en_36948.mp3,Henderson stood up with a spade in his hand.,8,0,male_masculine,8,3624
3077,1251174,common_voice_en_35056931.mp3,Especially as the main title of Margaret of Parma.,8,0,male_masculine,8,3996
3078,1180308,common_voice_en_24497.mp3,It was no more exciting than an overturned carriage or a tree blown across the road.,8,0,male_masculine,8,5616
3079,1831954,common_voice_en_37576421.mp3,These can be seen today on the tower staircase.,8,0,male_masculine,8,4140
3080,1180230,common_voice_en_24418.mp3,"I don't understand what you're talking about, the desert said.",8,0,male_masculine,8,4416
3081,453085,common_voice_en_45199.mp3,It was such a gradual movement that he found it only by noticing the dots.,8,0,male_masculine,8,3768
3082,1182252,common_voice_en_30531465.mp3,Capital Metro operates several services in the suburb Round Rock.,8,0,male_masculine,8,6048
3083,1180172,common_voice_en_24360.mp3,"So now, I fear nothing, because it was those omens that brought you to me.",8,0,male_masculine,8,5496
3084,453223,common_voice_en_45293.mp3,I thought about the difficulties in translation that might arise.,8,0,male_masculine,8,5304
3085,692594,common_voice_en_678681.mp3,But I didn’t think that it contained any living creature.,8,0,male_masculine,8,3528
3086,201658,common_voice_en_20904.mp3,Few people realise the immensity of vacancy.,8,0,male_masculine,8,4224
3087,201657,common_voice_en_20903.mp3,"Down below in the darkness were hundreds of people, sleeping in peace.",8,0,male_masculine,8,5904
3088,606367,common_voice_en_110974.mp3,Henderson stood up with a spade in his hand.,8,0,male_masculine,8,3216
3089,458626,common_voice_en_32838814.mp3,His three brothers and son were also officers in the Jordanian army.,8,0,male_masculine,8,6300
3090,453212,common_voice_en_45282.mp3,I went stretching my legs clumsily and feeling my way in the dark.,8,0,male_masculine,8,6456
3091,680146,common_voice_en_121588.mp3,There were lights in the upper windows of the houses when the people went to bed.,8,0,male_masculine,8,3600
3092,768270,common_voice_en_20982.mp3,But they really don't know what they're saying.,8,0,male_masculine,8,2904
3093,458627,common_voice_en_32838815.mp3,His year of birth is unknown.,8,0,male_masculine,8,4104
3094,276669,common_voice_en_32668910.mp3,Bill Monroe used the song from then on to close his concerts.,8,0,male_masculine,8,7416
3095,276679,common_voice_en_32669266.mp3,She also taught at Bennington College.,8,0,male_masculine,8,4932
3096,458628,common_voice_en_32838816.mp3,They are attracted to light and to sugar traps.,8,0,male_masculine,8,5076
3097,1182253,common_voice_en_30531466.mp3,She is professor at Tufts University.,8,0,male_masculine,8,4176
3098,1180215,common_voice_en_24403.mp3,It was a pleasant change from talking to his sheep.,8,0,male_masculine,8,3480
3099,1182255,common_voice_en_30531468.mp3,One of the panels depicts the house and the Thaddeus Fisher House.,8,0,male_masculine,8,5256
3100,458631,common_voice_en_32838819.mp3,The competition took place in Akita Prefectural Rink.,8,0,male_masculine,8,8136
3101,458632,common_voice_en_32838820.mp3,He was also the Managing Director of Bangladesh Overseas Employment and Services Limited.,8,0,male_masculine,8,7452
3102,1180219,common_voice_en_24407.mp3,Can't you just observe men and omens in order to understand the language? the boy asked.,8,0,male_masculine,8,5112
3103,458633,common_voice_en_32838821.mp3,Malaysian Cricket Association.,8,0,male_masculine,8,4068
3104,1022525,common_voice_en_74531.mp3,"We are part of that soul, so we rarely recognize that it is working for us.",8,0,male_masculine,8,5112
3105,1182345,common_voice_en_30531939.mp3,He did not feature very much for Cork City.,8,0,male_masculine,8,4680
3106,1182344,common_voice_en_30531938.mp3,He played for the United States collegiate national baseball team that summer.,8,0,male_masculine,8,5760
3107,652098,common_voice_en_34817.mp3,The boy observed in silence the progress of the animals and people across the desert.,8,0,male_masculine,8,8664
3108,1182343,common_voice_en_30531937.mp3,This allowed him to publish an album with Universal Music Group.,8,0,male_masculine,8,5256
3109,1182342,common_voice_en_30531936.mp3,Dorsum light brown.,8,0,male_masculine,8,2988
3110,776479,common_voice_en_13663.mp3,The boy listened quietly.,9,1,male_masculine,8,2904
3111,306445,common_voice_en_16161.mp3,Can I get a woot woot!?,8,0,male_masculine,8,2712
3112,12054,common_voice_en_17801789.mp3,Do you speak German?,8,0,male_masculine,8,2184
3113,1436010,common_voice_en_32515980.mp3,The competition was organized by the city of Seoul.,8,0,male_masculine,8,4248
3114,994174,common_voice_en_157728.mp3,"I know why I want to get back to my flock, he thought.",8,0,male_masculine,8,4104
3115,1706880,common_voice_en_38528052.mp3,Most of the victims in the attack were women and young children.,8,0,male_masculine,8,5040
3116,1209301,common_voice_en_32370368.mp3,She studies national and international maternal health.,8,0,male_masculine,8,4212
3117,1182340,common_voice_en_30531934.mp3,Novozakharovka is the nearest rural locality.,8,0,male_masculine,8,6120
3118,294110,common_voice_en_81801.mp3,But now the sounds inside had stopped.,9,1,male_masculine,8,2496
3119,1182339,common_voice_en_30531933.mp3,The station is between Agua Salud and Capitolio.,8,0,male_masculine,8,4968
3120,1443896,common_voice_en_20475117.mp3,The mountain is part of a natural park.,8,0,male_masculine,8,4728
3121,1734162,common_voice_en_30406470.mp3,He also sang with blues guitarist Earl Hooker.,9,1,male_masculine,8,4356
3122,575314,common_voice_en_32687777.mp3,Azerbaijani language,8,0,male_masculine,8,4104
3123,1182338,common_voice_en_30531902.mp3,Credits.,8,0,male_masculine,8,2376
3124,679198,common_voice_en_79002.mp3,"You don't have to be rich, skinny, popular, or even own a cape to perform a random act of kindness.",8,0,male_masculine,8,6336
3125,1182341,common_voice_en_30531935.mp3,His fate after the uprising is unknown.,8,0,male_masculine,8,4356
3126,1182355,common_voice_en_30531949.mp3,The ministry sponsored students to study abroad free of charge by giving them scholarships.,8,0,male_masculine,8,6480
3127,776421,common_voice_en_13604.mp3,"Men dream more about coming home than about leaving, the boy said.",8,0,male_masculine,8,7104
3128,1706928,common_voice_en_38529112.mp3,The Eagles instead drafted quarterback Donovan McNabb and they booed the Eagles draft pick.,8,0,male_masculine,8,8172
3129,1182353,common_voice_en_30531947.mp3,Insoluble in water and acetone.,8,0,male_masculine,8,3996
3130,1182352,common_voice_en_30531946.mp3,He committed to Wake Forest University to play college football.,8,0,male_masculine,8,5328
3131,699273,common_voice_en_22070928.mp3,eight,8,0,male_masculine,8,2160
3132,975107,common_voice_en_8607965.mp3,What is the matter?,8,0,male_masculine,8,1704
3133,575317,common_voice_en_32687799.mp3,Beaches in this area are suitable for swimming in summer.,8,0,male_masculine,8,5904
3134,361590,common_voice_en_12324.mp3,It may be the gases of the firing that caused the Martians inconvenience.,8,0,male_masculine,8,5856
3135,306433,common_voice_en_16148.mp3,"Looking through the telescope, I saw a circle of deep blue and the little round planet.",9,1,male_masculine,8,12408
3136,679153,common_voice_en_78957.mp3,Then suddenly he noticed it with a start.,8,0,male_masculine,8,2904
3137,1158054,common_voice_en_45022.mp3,The crowd swayed a little as I elbowed my way through.,8,0,male_masculine,8,3384
3138,776462,common_voice_en_13645.mp3,The boy said nothing.,9,1,male_masculine,8,3456
3139,679180,common_voice_en_78984.mp3,"As soon as he saw me among the crowd, he called to me to come down.",8,0,male_masculine,8,4344
3140,51648,common_voice_en_183.mp3,Strange images passed through my mind.,165,1,female_feminine,164,5184
3141,51646,common_voice_en_181.mp3,A large piece suddenly came off and fell with a loud and sharp noise.,134,3,female_feminine,131,8016
3142,51647,common_voice_en_182.mp3,A line of flame high can be seen in the atmosphere.,136,21,female_feminine,115,56712
3143,1463777,common_voice_en_32389110.mp3,The vehicle was therefore withdrawn.,55,0,female_feminine,55,4680
3144,309024,common_voice_en_1454.mp3,He took his money from his pouch and showed it to the young man.,48,1,female_feminine,47,4512
3145,313654,common_voice_en_1084.mp3,"Somewhere you are holding the person I love, the boy said.",46,0,female_feminine,46,5496
3146,309029,common_voice_en_1459.mp3,"And, for wise men, gold is the metal that evolved the furthest.",46,1,female_feminine,45,5976
3147,313659,common_voice_en_1089.mp3,Just by looking at them.,43,0,female_feminine,43,3624
3148,309030,common_voice_en_1460.mp3,The first rule of don't fight club is let's talk about it.,45,2,female_feminine,43,4584
3149,313661,common_voice_en_1091.mp3,"Well, I'd like to see their land, and see how they live, said his son.",42,1,female_feminine,41,5016
3150,313656,common_voice_en_1086.mp3,"If I could, I'd write a huge encyclopedia just about the words luck and coincidence.",41,0,female_feminine,41,6576
3151,1464306,common_voice_en_32914677.mp3,The sodium salt can be precipitated out of the solution by adding sodium chloride.,45,5,female_feminine,40,8460
3152,309036,common_voice_en_1466.mp3,"But there's a tribal war, the boy reiterated.",44,4,female_feminine,40,4752
3153,313650,common_voice_en_1080.mp3,The Englishman said nothing.,39,0,female_feminine,39,2904
3154,313655,common_voice_en_1085.mp3,I wished I had a light to smoke by.,39,0,female_feminine,39,3744
3155,313651,common_voice_en_1081.mp3,"The alchemist erased the circle in the sand, and the snake slithered away among the rocks.",39,1,female_feminine,38,9384
3156,313658,common_voice_en_1088.mp3,"Go and speak to the tribal chieftains, said the camel driver.",37,1,female_feminine,36,4464
3157,313657,common_voice_en_1087.mp3,"I've crossed these sands many times, said one of the camel drivers one night.",36,0,female_feminine,36,6696
3158,288751,common_voice_en_904.mp3,"Well, then, we've got a problem.",37,2,female_feminine,35,4656
3159,309027,common_voice_en_1457.mp3,He saw the boy appear from the other side of the dunes.,37,2,female_feminine,35,4944
3160,313649,common_voice_en_1079.mp3,"There was a full moon, and the boy told the Englishman the story of his life.",35,0,female_feminine,35,5016
3161,356413,common_voice_en_70902.mp3,"At most, they thought that another meteorite had descended.",34,0,female_feminine,34,6768
3162,313652,common_voice_en_1082.mp3,That doesn't happen to just anyone!,34,0,female_feminine,34,3216
3163,309031,common_voice_en_1461.mp3,"The alchemist stopped abruptly, and bent to the ground.",33,0,female_feminine,33,4728
3164,309023,common_voice_en_1453.mp3,"From atop its walls, one can catch a glimpse of Africa.",35,3,female_feminine,32,4944
3165,309035,common_voice_en_1465.mp3,He paused for a moment to see if the woman knew what the Egyptian pyramids were.,31,0,female_feminine,31,5832
3166,313647,common_voice_en_1077.mp3,And he hadn't perceived them because he had become accustomed to them.,32,1,female_feminine,31,6336
3167,313660,common_voice_en_1090.mp3,It was only when I got this close to it that the strangeness of it was at all evident to me.,32,2,female_feminine,30,6024
3168,313648,common_voice_en_1078.mp3,"Who told you that? asked the boy, startled.",31,1,female_feminine,30,4224
3169,288741,common_voice_en_894.mp3,"I have had the same dream twice, he said.",30,0,female_feminine,30,6024
3170,356421,common_voice_en_70910.mp3,"It seemed such a little thing, so bright and small and still.",31,2,female_feminine,29,5736
3171,309026,common_voice_en_1456.mp3,"Suddenly, for no apparent reason, the boy's horse began to slow.",30,1,female_feminine,29,5256
3172,288742,common_voice_en_895.mp3,The boy knew the desert sensed his fear.,30,1,female_feminine,29,6336
3173,313653,common_voice_en_1083.mp3,"Many people in Berkshire, Surrey, and Middlesex must have seen it.",30,1,female_feminine,29,4824
3174,309028,common_voice_en_1458.mp3,"The old man wore a breastplate of heavy gold, covered with precious stones.",31,2,female_feminine,29,6576
3175,309034,common_voice_en_1464.mp3,"Night fell, and an assortment of fighting men and merchants entered and exited the tent.",29,0,female_feminine,29,6384
3176,356417,common_voice_en_70906.mp3,And the sand and gravel had been flung violently in every direction.,30,2,female_feminine,28,6744
3177,309032,common_voice_en_1462.mp3,"The battles may last for a long time, perhaps even years.",29,1,female_feminine,28,5064
3178,1464343,common_voice_en_33000025.mp3,He departed Brest in June and reached Lisbon before returning in August.,30,5,female_feminine,25,5868
3179,288744,common_voice_en_897.mp3,That it was unable to deal with this boy who spoke the Language of the World.,29,4,female_feminine,25,7176
3180,288745,common_voice_en_898.mp3,"But if you have to go before then, go on in pursuit of your dream.",28,3,female_feminine,25,11304
3181,1192728,common_voice_en_32248929.mp3,Goldman then served on the gubernatorial campaign of Hugh Carey.,32,8,female_feminine,24,5616
3182,793886,common_voice_en_37038184.mp3,The protesters were shot by the police force inside the building after had surrendered.,24,0,female_feminine,24,9108
3183,1531024,common_voice_en_32266656.mp3,The accusation was based on the content of the official trailers.,26,2,female_feminine,24,5868
3184,288748,common_voice_en_901.mp3,"From here on, you will be alone, the alchemist said.",26,3,female_feminine,23,8616
3185,1661806,common_voice_en_37989526.mp3,The works were carried out at night and in a series of weekend closures.,22,0,female_feminine,22,5868
3186,1386600,common_voice_en_38682000.mp3,"It operates services to remote destinations in Venezuela, including tourist attractions.",26,4,female_feminine,22,9396
3187,240545,common_voice_en_10092.mp3,'m all about those invisible cosmic connections that transcend time and distance.,24,2,female_feminine,22,8064
3188,793865,common_voice_en_37038153.mp3,The first motion the club passed was in support of the marijuana initiative.,24,3,female_feminine,21,7056
3189,481056,common_voice_en_36485692.mp3,"He was married to famed cowgirl, Florence LaDue.",21,0,female_feminine,21,4896
3190,1522060,common_voice_en_36842503.mp3,The company headquarters are in the same building.,20,0,female_feminine,20,3060
3191,1464945,common_voice_en_37002503.mp3,Hogwood conducted a considerable amount of opera.,20,0,female_feminine,20,5040
3192,309033,common_voice_en_1463.mp3,"Bakers have homes, while shepherds sleep out in the open.",25,5,female_feminine,20,5736
3193,1463785,common_voice_en_32389125.mp3,It organises the annual Vienna Pride and Rainbow Parade.,20,0,female_feminine,20,5868
3194,288743,common_voice_en_896.mp3,"He rose, and made his way back toward the palm trees.",20,1,female_feminine,19,5616
3195,240551,common_voice_en_10100.mp3,He approached the mass and was surprised at the size and the shape.,22,3,female_feminine,19,4200
3196,963150,common_voice_en_32916272.mp3,The ship contains three decks.,18,0,female_feminine,18,2340
3197,309025,common_voice_en_1455.mp3,He took the fourth part and handed it to the monk.,26,8,female_feminine,18,5376
3198,523252,common_voice_en_39046989.mp3,See Telephone numbers in Taiwan.,18,0,female_feminine,18,2736
3199,1531931,common_voice_en_32374679.mp3,Excited for this song to exist in the world.,18,0,female_feminine,18,4140
3200,240544,common_voice_en_10091.mp3,Its lower end was still embedded.,20,2,female_feminine,18,3144
3201,493261,common_voice_en_38063266.mp3,"She was probably born at Dromana, in County Waterford.",18,0,female_feminine,18,4248
3202,394417,common_voice_en_18838.mp3,He approached the mass and was surprised at the size and the shape.,18,0,female_feminine,18,4944
3203,695125,common_voice_en_38064292.mp3,Running back Gary Brightwell lost three fumbles.,20,2,female_feminine,18,5148
3204,570296,common_voice_en_38607287.mp3,"For a history of economics, see the article History of economic thought.",18,0,female_feminine,18,4896
3205,215177,common_voice_en_13530.mp3,"As I watched, the planet seemed to grow larger and smaller.",17,0,female_feminine,17,5496
3206,288740,common_voice_en_891.mp3,"The Englishman vanished, too, gone to find the alchemist.",24,7,female_feminine,17,9024
3207,281092,common_voice_en_13775.mp3,"That's the principle that governs all things, he said.",17,0,female_feminine,17,4536
3208,1488557,common_voice_en_38394717.mp3,"His son, Sloan, is named after Allison's former head coach, Steve Sloan.",16,0,female_feminine,16,8316
3209,220307,common_voice_en_13539.mp3,"It was glaringly hot, not a cloud in the sky nor a breath of wind.",16,0,female_feminine,16,5904
3210,1147312,common_voice_en_37570060.mp3,West Somerset benefits from one of the most scenic landscapes in England.,18,2,female_feminine,16,4932
3211,215175,common_voice_en_13528.mp3,I was disappointed at this inanimate bulk.,17,1,female_feminine,16,4776
3212,1545887,common_voice_en_31991411.mp3,He voted consistently against the Administration.,16,0,female_feminine,16,4356
3213,981405,common_voice_en_37506044.mp3,During that period they also won the Derbyshire Senior Cup on four successive occasions.,16,0,female_feminine,16,6300
3214,1530312,common_voice_en_32255161.mp3,Shawn attributes the success to being willing to learn.,16,0,female_feminine,16,4428
3215,1192961,common_voice_en_32260080.mp3,The final standings were announced on the basis of the Regular season.,16,0,female_feminine,16,4392
3216,366699,common_voice_en_38212116.mp3,"Brand names include Alu-Cap, Aludrox, Gaviscon or Pepsamar.",16,0,female_feminine,16,8208
3217,1192744,common_voice_en_32249301.mp3,University budget to student ratio.,16,0,female_feminine,16,4500
3218,1077847,common_voice_en_32129295.mp3,He is known for his works on comparative literature.,18,3,female_feminine,15,3960
3219,394413,common_voice_en_18834.mp3,I locked eyes with a fish in the tank.,15,0,female_feminine,15,3984
3220,1463665,common_voice_en_32359719.mp3,The work consists of three volumes.,15,0,female_feminine,15,4176
3221,1084581,common_voice_en_35117944.mp3,This is my own thing.,15,0,female_feminine,15,3384
3222,281090,common_voice_en_13773.mp3,"The heat lasted until nightfall, and all that time he had to carry his jacket.",15,0,female_feminine,15,6072
3223,1464870,common_voice_en_36910233.mp3,A similar legend was told of his miraculous conception at the hearth.,20,5,female_feminine,15,6156
3224,1463706,common_voice_en_32359897.mp3,It was way too slow to follow the army.,15,0,female_feminine,15,4500
3225,615296,common_voice_en_36851510.mp3,It is situated directly on the coast in a remote location.,18,3,female_feminine,15,5184
3226,743592,common_voice_en_37470761.mp3,"In an interview also in ""The Daily Telegraph"", Laurie confirmed his atheism.",15,0,female_feminine,15,7344
3227,1463759,common_voice_en_32388963.mp3,He dropped out of higher secondary school in order to pursue his passion.,15,0,female_feminine,15,7020
3228,1463749,common_voice_en_32371413.mp3,Bergmann.,15,0,female_feminine,15,3276
3229,1464921,common_voice_en_36960059.mp3,"The word ""trillo"" is sometimes used to mean the same as trill.",15,0,female_feminine,15,6408
3230,1463746,common_voice_en_32371410.mp3,The case was sent to the Asian Human Rights Commission.,15,0,female_feminine,15,5616
3231,215174,common_voice_en_13527.mp3,"I pointed out Mars, a bright dot of light.",16,1,female_feminine,15,4992
3232,266230,common_voice_en_12823.mp3,"In those times, the Master Work could be written simply on an emerald.",15,0,female_feminine,15,4872
3233,1464136,common_voice_en_32886936.mp3,He saw action in southern France and the Rhineland.,15,0,female_feminine,15,4428
3234,266233,common_voice_en_12829.mp3,The newspaper articles had prepared everyone for the reception of the idea.,15,0,female_feminine,15,6072
3235,1463807,common_voice_en_32389262.mp3,Other campaigners acquired houses in the square.,15,0,female_feminine,15,5148
3236,1464337,common_voice_en_32999997.mp3,Both parts were the most watched episode of their respective series.,15,0,female_feminine,15,5688
3237,1464972,common_voice_en_37153421.mp3,"So from these experiences in childhood, these ideas for Pokemon came out.",20,5,female_feminine,15,7596
3238,1464469,common_voice_en_33078028.mp3,Only small terrariums are needed to keep them.,15,0,female_feminine,15,5220
3239,1464288,common_voice_en_32914517.mp3,He then took over the psychology program at Tokyo Imperial University after Motora died.,15,0,female_feminine,15,8568
3240,1464611,common_voice_en_33732684.mp3,That was the end of the Khen dynasty.,15,0,female_feminine,15,3996
3241,1464458,common_voice_en_33077969.mp3,She then disappears from online sources.,20,5,female_feminine,15,4176
3242,1464265,common_voice_en_32914441.mp3,Both desire someone to be murdered but fear being caught.,15,0,female_feminine,15,5508
3243,1464082,common_voice_en_32865334.mp3,She had the previous name of Veinte de Julio prior to renaming.,15,0,female_feminine,15,7236
3244,944628,common_voice_en_33393686.mp3,The Israeli government has prohibited the artist from entering Israel because of the piece.,15,0,female_feminine,15,5796
3245,538887,common_voice_en_59389.mp3,I thought about the difficulties in translation that might arise.,15,0,female_feminine,15,4320
3246,1375907,common_voice_en_38358199.mp3,"This included the first issues of ""The Incredible Hulk"" and ""The X-Men"".",21,6,female_feminine,15,7056
3247,1464345,common_voice_en_33000035.mp3,The highway then enters Lafayette County.,15,0,female_feminine,15,3960
3248,1077756,common_voice_en_32129136.mp3,"Some ""yin miao"" are dedicated to deceased unmarried women.",15,0,female_feminine,15,4968
3249,1464436,common_voice_en_33055453.mp3,There is buoyant ascent training.,15,0,female_feminine,15,3996
3250,1464090,common_voice_en_32865348.mp3,The travel became more difficult and dangerous.,15,0,female_feminine,15,4716
3251,1464238,common_voice_en_32914374.mp3,The King bitterly repents his actions.,15,0,female_feminine,15,3888
3252,1464442,common_voice_en_33055857.mp3,All figures are for the census de facto population count.,15,0,female_feminine,15,5580
3253,290640,common_voice_en_2747.mp3,The end of the cylinder was still as Ogilvy and Henderson had left it.,16,1,female_feminine,15,7104
3254,240543,common_voice_en_10090.mp3,And the sand and gravel had been flung violently in every direction.,15,0,female_feminine,15,5544
3255,1375446,common_voice_en_38266267.mp3,They could eat the stalks and upper parts of the plants.,15,0,female_feminine,15,5940
3256,944569,common_voice_en_32836422.mp3,From there he attended Oundle School in Northamptonshire.,15,0,female_feminine,15,4320
3257,1464199,common_voice_en_32913965.mp3,Russians called him Little Alexander.,15,0,female_feminine,15,4320
3258,290647,common_voice_en_2755.mp3,The Englishman was disappointed.,16,1,female_feminine,15,4656
3259,944579,common_voice_en_32836549.mp3,Kalchirburan is the nearest rural locality.,15,0,female_feminine,15,3996
3260,394403,common_voice_en_18824.mp3,I had seen all that it would presently bring me.,15,0,female_feminine,15,3696
3261,1463902,common_voice_en_32644465.mp3,The national anthem would be performed by the United States Army Chorus.,15,0,female_feminine,15,7416
3262,999573,common_voice_en_32877069.mp3,He will also executive produce the project.,15,0,female_feminine,15,3456
3263,1464956,common_voice_en_37081083.mp3,He also played a pivotal role in persuading Europe to import Malaysia's timber.,15,0,female_feminine,15,6840
3264,1464134,common_voice_en_32886934.mp3,His dating is not acceptable.,15,0,female_feminine,15,3888
3265,1464499,common_voice_en_33165573.mp3,It quickly grew to the largest organic sports highlight Snapchat account on the platform.,15,0,female_feminine,15,7488
3266,1464764,common_voice_en_35282691.mp3,However the usual number of the laid eggs is very small.,15,0,female_feminine,15,6048
3267,944604,common_voice_en_32836946.mp3,It saw the election of Victor Ashe.,15,0,female_feminine,15,4176
3268,1463821,common_voice_en_32389309.mp3,Brothers are being blessed by sisters on this special day.,15,0,female_feminine,15,5580
3269,1464151,common_voice_en_32887114.mp3,We were going to get married.,15,0,female_feminine,15,4140
3270,1464477,common_voice_en_33114988.mp3,His unnatural death has not been resolved.,15,0,female_feminine,15,4320
3271,1464697,common_voice_en_35024145.mp3,Mark Hewitson was elected in a postponed poll in August.,15,0,female_feminine,15,6660
3272,944607,common_voice_en_32836949.mp3,One of his pupils was Serafino Viani.,15,0,female_feminine,15,3960
3273,1464184,common_voice_en_32913890.mp3,"The lake formed by the reservoir is called ""Sacred Water Lake"".",15,0,female_feminine,15,7056
3274,1464076,common_voice_en_32865315.mp3,One of his siblings was the actress Nora Nicholson.,15,0,female_feminine,15,5616
3275,290642,common_voice_en_2750.mp3,He started to read the book he had bought.,15,1,female_feminine,14,9240
3276,281088,common_voice_en_13771.mp3,He saw the boy appear from the other side of the dunes.,15,1,female_feminine,14,4632
3277,240549,common_voice_en_10097.mp3,"We don't know what's in the confounded thing, do you?",16,2,female_feminine,14,4104
3278,1663662,common_voice_en_38022658.mp3,Surgery is usually curative.,14,0,female_feminine,14,3708
3279,1386630,common_voice_en_38686269.mp3,It is used to check the radius of inner and outer surfaces.,16,2,female_feminine,14,6300
3280,266234,common_voice_en_12830.mp3,"But my heart is agitated, the boy said.",15,1,female_feminine,14,4464
3281,240546,common_voice_en_10094.mp3,"As soon as he saw me among the crowd, he called to me to come down.",14,0,female_feminine,14,4848
3282,567502,common_voice_en_33125635.mp3,She was refloated seventeen day later and resumed her voyage to Sierra Leone.,14,0,female_feminine,14,8640
3283,1657274,common_voice_en_37900259.mp3,I love you all so much.,14,0,female_feminine,14,3420
3284,1109978,common_voice_en_31961735.mp3,Finnfund’s statutory duty is to promote economic and social development in developing countries.,14,0,female_feminine,14,8100
3285,394415,common_voice_en_18836.mp3,It seemed so safe and tranquil.,15,1,female_feminine,14,3048
3286,375901,common_voice_en_37649.mp3,Absolutely despicable that gingerbread men are forced to live in houses made of their own flesh.,14,0,female_feminine,14,8856
3287,400257,common_voice_en_17543346.mp3,"Glass eel is on the menu today, but it's too expensive.",14,0,female_feminine,14,4224
3288,1545257,common_voice_en_31937820.mp3,It has nocturnal habits and preys mainly on lizards.,14,0,female_feminine,14,3960
3289,1488582,common_voice_en_38398334.mp3,Fano made various contributions on projective and algebraic geometry.,14,0,female_feminine,14,7200
3290,921898,common_voice_en_39143019.mp3,It is inscribed on the list of the Immovable Cultural Monuments of National Significance.,14,0,female_feminine,14,7848
3291,1530456,common_voice_en_32259238.mp3,The old shipyard was then renamed (northern shipyard).,14,0,female_feminine,14,4896
3292,215180,common_voice_en_13533.mp3,And then he perceived it very slowly.,15,1,female_feminine,14,4128
3293,1659882,common_voice_en_37954432.mp3,He was the author of several books on the English language.,14,0,female_feminine,14,5688
3294,266235,common_voice_en_12831.mp3,"I used to live near El Cairum, he said.",14,1,female_feminine,13,5616
3295,1671993,common_voice_en_20286077.mp3,Maddstone allows him to bleed to death over the course of an hour.,13,0,female_feminine,13,5712
3296,290646,common_voice_en_2754.mp3,"And you've told me nothing along the way, said the boy.",13,0,female_feminine,13,6456
3297,489341,common_voice_en_71786.mp3,"He did find it, soon after dawn, and not far from the sand pits.",13,0,female_feminine,13,4968
3298,240550,common_voice_en_10098.mp3,"At the first glance, it was really not very exciting.",15,2,female_feminine,13,4776
3299,711847,common_voice_en_42082.mp3,"The boy was embarrassed, and confessed that he had observed nothing.",13,0,female_feminine,13,5568
3300,266236,common_voice_en_12832.mp3,We'll have something to drink and eat these hawks.,13,0,female_feminine,13,4584
3301,240547,common_voice_en_10095.mp3,"He moved about, invisible but everyone could hear him.",15,2,female_feminine,13,5280
3302,399501,common_voice_en_9751.mp3,The boy picked up his pouch and put it with his other things.,14,1,female_feminine,13,5592
3303,1150471,common_voice_en_26065.mp3,"It helped me to trust in people, the Englishman answered.",13,0,female_feminine,13,3648
3304,1150505,common_voice_en_26099.mp3,It drew a droplet of blood.,13,0,female_feminine,13,2184
3305,281093,common_voice_en_13776.mp3,He spent the entire morning observing the infrequent comings and goings in the street.,13,0,female_feminine,13,6048
3306,437969,common_voice_en_31920664.mp3,This was followed by studies in London.,12,0,female_feminine,12,3456
3307,659573,common_voice_en_32699064.mp3,It received Government funding and crushed ore for neighbouring mines.,12,0,female_feminine,12,5148
3308,1150441,common_voice_en_26035.mp3,Should I understand the Emerald Tablet? the boy asked.,12,0,female_feminine,12,3408
3309,865523,common_voice_en_38550573.mp3,At the same time there were problems at home.,12,0,female_feminine,12,3744
3310,368956,common_voice_en_36978016.mp3,The English edition was translated by Adam Kotsko.,12,0,female_feminine,12,4140
3311,1488705,common_voice_en_38404659.mp3,The main characters of these storylines are automatically made members of the school.,12,0,female_feminine,12,6516
3312,1147377,common_voice_en_37570291.mp3,The mother is in no way the head of the family.,12,0,female_feminine,12,3456
3313,323966,common_voice_en_32352431.mp3,Six hundred years of Jewish life in Romania.,12,0,female_feminine,12,4752
3314,227752,common_voice_en_41868.mp3,I got drunk yesterday and thought I built a super computer.,12,0,female_feminine,12,6336
3315,797230,common_voice_en_30453348.mp3,David Baker was the team captain.,12,0,female_feminine,12,3888
3316,438110,common_voice_en_57002.mp3,It seemed to him that it fell to earth about one hundred miles east of here.,12,0,female_feminine,12,7560
3317,538875,common_voice_en_59375.mp3,"As I watched, the planet seemed to grow larger and smaller.",12,0,female_feminine,12,4296
3318,182782,common_voice_en_38800069.mp3,"This is not King Hyperion, or Supreme Power Hyperion, this is not Gruenwald's Hyperion.",15,3,female_feminine,12,9468
3319,240552,common_voice_en_10102.mp3,I got drunk yesterday and thought I built a super computer.,17,5,female_feminine,12,4800
3320,1659647,common_voice_en_37952084.mp3,"He was married to the sea, but Olympic was his mistress.",14,2,female_feminine,12,6228
3321,875569,common_voice_en_35064088.mp3,"He did not return Emperor Hui to Luoyang, but kept him at Yecheng.",12,0,female_feminine,12,5868
3322,1192888,common_voice_en_32259982.mp3,He was born in la Rioja.,12,0,female_feminine,12,2808
3323,1192840,common_voice_en_32259931.mp3,The album peaked at number two on the Spanish Albums Chart.,12,0,female_feminine,12,4176
3324,1192838,common_voice_en_32259929.mp3,The local economy is primarily based upon agriculture and nearby mineral resources.,12,0,female_feminine,12,6300
3325,921888,common_voice_en_39142993.mp3,It is from these higher powers that he expects every blessing.,12,0,female_feminine,12,5796
3326,220304,common_voice_en_13536.mp3,I was disappointed at this inanimate bulk.,13,1,female_feminine,12,3768
3327,266237,common_voice_en_12833.mp3,"Well, interpret the dream, he said.",12,0,female_feminine,12,3336
3328,290641,common_voice_en_2749.mp3,"One afternoon, one of his servants fell ill, and it appeared that he would die.",12,0,female_feminine,12,6816
3329,1150607,common_voice_en_26201.mp3,"Maybe the alchemist has never been in love, the boy thought.",12,0,female_feminine,12,4200
3330,713356,common_voice_en_20285270.mp3,Sound effects were handled primarily by Floyd Caton.,12,0,female_feminine,12,4392
3331,290638,common_voice_en_2745.mp3,"The boy was shaking with fear, but the alchemist helped him out of the tent.",13,1,female_feminine,12,5112
3332,1192900,common_voice_en_32259995.mp3,The boardroom at Tranby is named after Clint.,12,0,female_feminine,12,3924
3333,1192701,common_voice_en_32248901.mp3,It is accompanied by the oboes as the first bass recitative.,12,0,female_feminine,12,5688
3334,215176,common_voice_en_13529.mp3,Ogilvy told him everything that he had seen.,14,2,female_feminine,12,3504
3335,215173,common_voice_en_13526.mp3,"I thought about whether we should find coins and models in it, and so on.",13,1,female_feminine,12,6144
3336,215172,common_voice_en_13525.mp3,A large portion of the cylinder had been uncovered.,13,1,female_feminine,12,3744
3337,1192772,common_voice_en_32249374.mp3,Some deterioration of the verandah balcony timber was evident.,12,0,female_feminine,12,5400
3338,1192767,common_voice_en_32249359.mp3,The economy is supported primarily by farming and ranching.,12,0,female_feminine,12,4968
3339,793899,common_voice_en_37125946.mp3,All songs written by Natalie Merchant.,12,0,female_feminine,12,4536
3340,250080,common_voice_en_38783375.mp3,"It also had Nissan brand hexagonal hubcaps, whitewall tires, and sun roof.",12,0,female_feminine,12,7236
3341,1192704,common_voice_en_32248904.mp3,These tests are responsible for the unofficial designation of this vehicle.,12,0,female_feminine,12,6156
3342,974606,common_voice_en_36948686.mp3,In nucleophilic substitution reactions cyanate usually forms an isocyanate.,12,0,female_feminine,12,7668
3343,698851,common_voice_en_32639329.mp3,He served as judge of the military court in Uganda.,12,0,female_feminine,12,4176
3344,793920,common_voice_en_37126095.mp3,"The law only guarantees ""admission"" into university.",12,0,female_feminine,12,6228
3345,215179,common_voice_en_13532.mp3,Even then he hardly understood what this meant.,13,1,female_feminine,12,4440
3346,1193002,common_voice_en_32260143.mp3,She has the rare ability to play some of the most difficult passages.,12,0,female_feminine,12,5004
3347,698850,common_voice_en_32639315.mp3,His only friends are his sister Meridith and another scientist called Courtney.,12,0,female_feminine,12,5508
3348,1657780,common_voice_en_37914943.mp3,It is owned by Carlsberg.,14,2,female_feminine,12,3636
3349,1192955,common_voice_en_32260068.mp3,A privet hedge surrounds the square behind modern railings.,12,0,female_feminine,12,4356
3350,1192931,common_voice_en_32260036.mp3,The Dresden Plant features three units.,12,0,female_feminine,12,3276
3351,290648,common_voice_en_2756.mp3,Tangier is not like the rest of Africa.,12,0,female_feminine,12,12816
3352,394420,common_voice_en_18841.mp3,Henderson went into the railway station to telegraph the news to London.,12,0,female_feminine,12,4944
3353,1150531,common_voice_en_26125.mp3,"Enough, said the boy.",12,0,female_feminine,12,2184
3354,220302,common_voice_en_13534.mp3,But they were not there.,13,1,female_feminine,12,2976
3355,1192920,common_voice_en_32260022.mp3,The boat has seven winches provided as standard equipment.,12,0,female_feminine,12,3960
3356,159886,common_voice_en_19191.mp3,You can't believe it's not butter?,13,1,female_feminine,12,4224
3357,1192990,common_voice_en_32260120.mp3,In their palms can be seen like the first satellites.,12,0,female_feminine,12,4284
3358,1192671,common_voice_en_32248770.mp3,Overview.,12,0,female_feminine,12,2736
3359,227616,common_voice_en_101256.mp3,The guy thought he was a lunatic at large and made an unsuccessful attempt to stop him.,11,0,female_feminine,11,5304
3360,101992,common_voice_en_34208.mp3,Now I will drift gently off to dreamland.,11,0,female_feminine,11,6240
3361,220305,common_voice_en_13537.mp3,No doubt the impact had caused a flash of fire.,13,2,female_feminine,11,4800
3362,1150649,common_voice_en_26243.mp3,But the boy knew that he was referring to Fatima.,11,0,female_feminine,11,3456
3363,394410,common_voice_en_18831.mp3,Replace the Ts in Tim Tebow's name with any other consonant to get a Star Wars character,12,1,female_feminine,11,6744
3364,823091,common_voice_en_31634331.mp3,It has channel siding.,12,1,female_feminine,11,2520
3365,567277,common_voice_en_83137.mp3,He was immensely excited at the news.,11,0,female_feminine,11,2640
3366,711849,common_voice_en_42084.mp3,The boy approached her to ask about the alchemist.,11,0,female_feminine,11,4272
3367,399502,common_voice_en_9752.mp3,"This is the first phase of the job, he said.",13,2,female_feminine,11,3984
3368,394409,common_voice_en_18830.mp3,My tax dollars pay for those public school proms.,12,1,female_feminine,11,4824
3369,399494,common_voice_en_9743.mp3,"But instead of being saddened, he was happy.",16,5,female_feminine,11,4632
3370,220303,common_voice_en_13535.mp3,"I pointed out Mars, a bright dot of light.",14,3,female_feminine,11,4272
3371,288746,common_voice_en_899.mp3,Some storms are worth the wreckage.,22,11,female_feminine,11,6216
3372,1150540,common_voice_en_26134.mp3,"Drink and enjoy yourself, said the alchemist, noticing that the boy was feeling happier.",11,0,female_feminine,11,5592
3373,1150509,common_voice_en_26103.mp3,And that's where the power of love comes in.,11,0,female_feminine,11,2664
3374,220310,common_voice_en_13542.mp3,But that was simply because my eye was tired.,13,2,female_feminine,11,4608
3375,713368,common_voice_en_20285332.mp3,The county was named for Twin Lakes.,11,0,female_feminine,11,3792
3376,398714,common_voice_en_83435.mp3,"This is for you, he said, holding one of the parts out to the monk.",11,0,female_feminine,11,6168
3377,1150474,common_voice_en_26068.mp3,The boy tried to read what was written in the sand.,11,0,female_feminine,11,3144
3378,489361,common_voice_en_71806.mp3,A thin circle of bright metal showed between the top and the body of the cylinder.,11,0,female_feminine,11,5688
3379,713374,common_voice_en_20285358.mp3,Government officials saw that the public readily accepted the merchant tokens.,13,2,female_feminine,11,4920
3380,1150495,common_voice_en_26089.mp3,This wasn't a strange place; it was a new one.,11,0,female_feminine,11,3096
3381,1464198,common_voice_en_32913964.mp3,The window cleaner ignores her.,10,0,female_feminine,10,3996
3382,1464122,common_voice_en_32886864.mp3,She is particularly interested in what allows corals to become resistant to climate change.,10,0,female_feminine,10,7380
3383,1464120,common_voice_en_32886862.mp3,The game is the longest scoreless tie in baseball history.,10,0,female_feminine,10,6156
3384,1464087,common_voice_en_32865344.mp3,It is well written and humorous.,10,0,female_feminine,10,3960
3385,1464196,common_voice_en_32913955.mp3,His nomination was welcomed by the Federation of Korean Trade Unions.,10,0,female_feminine,10,7308
3386,1464200,common_voice_en_32913966.mp3,The assault guns that were to act in support did not arrive in time.,10,0,female_feminine,10,7380
3387,1464202,common_voice_en_32913980.mp3,Finch was educated in the Mississippi Conference Training School.,10,0,female_feminine,10,5508
3388,1464203,common_voice_en_32913981.mp3,The art dealer moved into the building that May after an extensive renovation.,10,0,female_feminine,10,6696
3389,1464208,common_voice_en_32914006.mp3,Many Muslims from other parts of the country took part as well.,10,0,female_feminine,10,5580
3390,1464207,common_voice_en_32914005.mp3,The present state of the work makes it impossible to define its origins precisely.,10,0,female_feminine,10,6588
3391,1464206,common_voice_en_32914004.mp3,The Hafei Baili was inspired largely from the Daewoo Tico.,10,0,female_feminine,10,7488
3392,1464209,common_voice_en_32914007.mp3,And is of Tongan descent.,10,0,female_feminine,10,3816
3393,1464204,common_voice_en_32913982.mp3,He served as district committeeman of the Boy Scouts for two years.,10,0,female_feminine,10,5508
3394,1464205,common_voice_en_32913983.mp3,The storm also produced waves.,10,0,female_feminine,10,3168
3395,1464121,common_voice_en_32886863.mp3,The Beeman Formation consists of cyclic shale and argillaceous limestone with some conglomerate.,10,0,female_feminine,10,8388
3396,1464225,common_voice_en_32914106.mp3,Jim Justice.,10,0,female_feminine,10,3276
3397,1464224,common_voice_en_32914092.mp3,The structure was built of rendered sandstone rubble.,10,0,female_feminine,10,5040
3398,1464226,common_voice_en_32914107.mp3,It is revealed that the baby is of oriental descent.,10,0,female_feminine,10,5976
3399,1661687,common_voice_en_37988112.mp3,Since then they have been held every three years.,10,0,female_feminine,10,4896
3400,1464222,common_voice_en_32914090.mp3,Minor league baseball has not returned to Pauls Valley.,10,0,female_feminine,10,5868
3401,1464101,common_voice_en_32886756.mp3,He is the author of several books in the field of probability.,10,0,female_feminine,10,6840
3402,1464102,common_voice_en_32886757.mp3,It has been isolated from lichens in other genera as well.,10,0,female_feminine,10,7956
3403,1464108,common_voice_en_32886773.mp3,He was survived by his wife and child.,10,0,female_feminine,10,4140
3404,1464221,common_voice_en_32914089.mp3,A specific change impacts the multiplayer hunting difficulty.,10,0,female_feminine,10,5796
3405,1464109,common_voice_en_32886774.mp3,His primary instructor was Alexander von Wagner.,10,0,female_feminine,10,5868
3406,1464220,common_voice_en_32914088.mp3,It was directed by Esteban Valdez who also wrote and edited the video.,10,0,female_feminine,10,6768
3407,1464219,common_voice_en_32914069.mp3,The museum quickly became popular and hosted many visitors.,10,0,female_feminine,10,4860
3408,1464197,common_voice_en_32913956.mp3,He started doing chemical experiments at home since his junior high school days.,10,0,female_feminine,10,7416
3409,1464112,common_voice_en_32886792.mp3,"Mask ""Lucha de Apuestas"" against each other.",10,0,female_feminine,10,7020
3410,1464218,common_voice_en_32914067.mp3,He was politically active during his younger years.,10,0,female_feminine,10,4176
3411,1464217,common_voice_en_32914044.mp3,The final tally is printed in the Senate and House journals.,10,0,female_feminine,10,5508
3412,1464113,common_voice_en_32886794.mp3,She started teaching philosophy in Lille before relocating to Amiens.,10,0,female_feminine,10,8100
3413,1464216,common_voice_en_32914042.mp3,He also trained as an artist in his native city.,10,0,female_feminine,10,4356
3414,1464183,common_voice_en_32913889.mp3,This formalises what we've discussed,10,0,female_feminine,10,4968
3415,1464214,common_voice_en_32914037.mp3,The airport lacks commercial airline services.,10,0,female_feminine,10,5148
3416,1464212,common_voice_en_32914022.mp3,They fall for each other gradually.,10,0,female_feminine,10,4176
3417,1464211,common_voice_en_32914021.mp3,"The strike also provided the ""Estado Novo"" with the opportunity to introduce further repression.",10,0,female_feminine,10,9000
3418,1464116,common_voice_en_32886823.mp3,The treaty effectively signaled the end of Susquehannock life in Maryland.,10,0,female_feminine,10,8208
3419,1464210,common_voice_en_32914008.mp3,The person who was in the process of being detained was also detained.,10,0,female_feminine,10,6156
3420,1464117,common_voice_en_32886824.mp3,Most of his letters and botanical specimens are at Kew.,10,0,female_feminine,10,6768
3421,1464118,common_voice_en_32886825.mp3,The city paraded Wiley down its Main Street.,10,0,female_feminine,10,6048
3422,1464110,common_voice_en_32886775.mp3,Gopal has introduced other bills to help combat the opioid crisis.,10,0,female_feminine,10,6768
3423,1464168,common_voice_en_32913748.mp3,Principal photography took place in Broad Ripple High School.,10,0,female_feminine,10,6156
3424,1464103,common_voice_en_32886758.mp3,Lan Lan and Kang Kang caused an immediate sensation when they arrived in Japan.,10,0,female_feminine,10,8028
3425,1464166,common_voice_en_32913730.mp3,He started rowing when he was eleven.,10,0,female_feminine,10,4356
3426,265583,common_voice_en_38282318.mp3,The telling of these stories is believed to promote the growth of crops.,10,0,female_feminine,10,5004
3427,1464164,common_voice_en_32913728.mp3,The biggest difference is the ending of the film.,10,0,female_feminine,10,4500
3428,1464162,common_voice_en_32913685.mp3,The team phase of the game concluded after the fourth eviction.,10,0,female_feminine,10,5400
3429,1464161,common_voice_en_32913684.mp3,I can’t see much more you could ask of him.,10,0,female_feminine,10,5688
3430,1464159,common_voice_en_32913682.mp3,Other provinces and private organizations also provided aid to Batanes.,10,0,female_feminine,10,8496
3431,1464158,common_voice_en_32913641.mp3,His son William would be knighted and own lands in Bishop Wilton.,10,0,female_feminine,10,6516
3432,1464155,common_voice_en_32913638.mp3,Newark is organized under the Faulkner Act.,10,0,female_feminine,10,6300
3433,1464154,common_voice_en_32913637.mp3,The population is stable.,10,0,female_feminine,10,4680
3434,1464153,common_voice_en_32887116.mp3,These mathematical expressions are a little scary,10,0,female_feminine,10,4716
3435,1464129,common_voice_en_32886903.mp3,He is the current Minister of Health and Social Security.,10,0,female_feminine,10,5076
3436,266238,common_voice_en_12834.mp3,"Don't say anything, Fatima interrupted.",13,3,female_feminine,10,3840
3437,1464119,common_voice_en_32886826.mp3,Bertha identified the body and told the police of Read.,10,0,female_feminine,10,6120
3438,1464137,common_voice_en_32886963.mp3,Most of the locals work in agriculture and fisheries.,10,0,female_feminine,10,5436
3439,1464149,common_voice_en_32887112.mp3,He is then struck in the chest with an axe and Bobby hides.,10,0,female_feminine,10,7740
3440,489358,common_voice_en_71803.mp3,"Yet, it was a little too large for assurance.",10,0,female_feminine,10,4248
3441,1464138,common_voice_en_32886964.mp3,Toki’s father was the chief pathologist for Lagos state.,10,0,female_feminine,10,5148
3442,1464140,common_voice_en_32886966.mp3,These were major publishers of prints.,10,0,female_feminine,10,3708
3443,1464141,common_voice_en_32886992.mp3,Akiko sails away from the port alone.,10,0,female_feminine,10,5328
3444,440465,common_voice_en_36957802.mp3,The figure is fastened to a high tree around which the people dance noisily.,10,0,female_feminine,10,5868
3445,1464148,common_voice_en_32887086.mp3,Use at your own risk,10,0,female_feminine,10,4608
3446,1464147,common_voice_en_32887085.mp3,No longer with the Senators.,10,0,female_feminine,10,3780
3447,1464142,common_voice_en_32886994.mp3,Many of his landscapes are of scenes in Germany and the Netherlands.,10,0,female_feminine,10,6156
3448,1464144,common_voice_en_32886996.mp3,The District head quarter of the village is Udaipur.,10,0,female_feminine,10,5508
3449,1464152,common_voice_en_32887115.mp3,They also toured throughout the United Kingdom and United States.,10,0,female_feminine,10,5868
3450,1464195,common_voice_en_32913954.mp3,The Big Green finished fourth in the Ivy League.,10,0,female_feminine,10,5976
3451,1464192,common_voice_en_32913938.mp3,It is largely accepted that Maxwell was falsely convicted.,10,0,female_feminine,10,5220
3452,1464191,common_voice_en_32913937.mp3,All this threatened the complete encirclement of the German group.,10,0,female_feminine,10,4968
3453,1464190,common_voice_en_32913936.mp3,One of the passengers on board was rabbi Moshe Teitelbaum.,10,0,female_feminine,10,7380
3454,1464189,common_voice_en_32913935.mp3,Teams were selected using the Athlete Selection criteria.,10,0,female_feminine,10,5256
3455,1464187,common_voice_en_32913893.mp3,Republicans remained in control of the chamber.,10,0,female_feminine,10,4716
3456,1464186,common_voice_en_32913892.mp3,The family character prevails in all social situations.,10,0,female_feminine,10,5940
3457,1464185,common_voice_en_32913891.mp3,It was their first championship title.,10,0,female_feminine,10,4248
3458,1464124,common_voice_en_32886882.mp3,The couples performed one unlearned routine.,10,0,female_feminine,10,5328
3459,1464125,common_voice_en_32886883.mp3,It has also been detected in the radio band.,10,0,female_feminine,10,6768
3460,1464126,common_voice_en_32886885.mp3,His wife Raisa Gorbachev feared that the ad could harm his reputation.,10,0,female_feminine,10,8280
3461,1464182,common_voice_en_32913848.mp3,It specializes in hot dogs and french fries.,10,0,female_feminine,10,5076
3462,1464170,common_voice_en_32913750.mp3,The series is based on the backdrop of Village.,10,0,female_feminine,10,5220
3463,1464180,common_voice_en_32913846.mp3,He had moved from Kentucky to southern Missouri.,10,0,female_feminine,10,5256
3464,1464179,common_voice_en_32913842.mp3,The stem may appear translucent near the base.,10,0,female_feminine,10,4428
3465,1464178,common_voice_en_32913807.mp3,Tsumura won the fight by majority decision.,10,0,female_feminine,10,4536
3466,1464128,common_voice_en_32886902.mp3,Two amateur players progressed through the first round.,10,0,female_feminine,10,4896
3467,1464177,common_voice_en_32913805.mp3,His attendance was the subject of controversy.,10,0,female_feminine,10,4356
3468,1464176,common_voice_en_32913804.mp3,The song was his idea.,10,0,female_feminine,10,3816
3469,1464130,common_voice_en_32886904.mp3,This is the story of how they understand the true meaning of family life.,10,0,female_feminine,10,6840
3470,1464131,common_voice_en_32886905.mp3,She has also been vocal about her experiences with body shaming.,10,0,female_feminine,10,6660
3471,1464133,common_voice_en_32886933.mp3,He displays the arms of Cantilupe of Greasley sculpted on his shield.,10,0,female_feminine,10,6588
3472,1464174,common_voice_en_32913776.mp3,They have Filipino heritage.,10,0,female_feminine,10,4860
3473,1464172,common_voice_en_32913774.mp3,The series was won by Victoria.,10,0,female_feminine,10,3960
3474,1464171,common_voice_en_32913751.mp3,The lips of the upper jaw are dark.,10,0,female_feminine,10,4896
3475,1386619,common_voice_en_38686181.mp3,The only disadvantage to the plastic slip sheet is the high cost.,12,2,female_feminine,10,5868
3476,1464181,common_voice_en_32913847.mp3,"The contestant must choose which ""expert"" wants to compete with.",10,0,female_feminine,10,6048
3477,1464377,common_voice_en_33000108.mp3,Tholeiitic basalt constitutes the primary rock type.,10,0,female_feminine,10,6408
3478,1464380,common_voice_en_33000111.mp3,It is only found on Big South Cape Island.,10,0,female_feminine,10,3888
3479,1150616,common_voice_en_26210.mp3,"Looking down at the spoon he held, the boy saw that the oil was gone.",10,0,female_feminine,10,4008
3480,1464383,common_voice_en_33000127.mp3,He is an ex member of West Bengal Legislative Assembly.,10,0,female_feminine,10,5328
3481,1464387,common_voice_en_33000131.mp3,Almost half of the book is dedicated to demons and magic.,10,0,female_feminine,10,4716
3482,1464389,common_voice_en_33000138.mp3,He was buried in Manama Cemetery.,10,0,female_feminine,10,3888
3483,1464359,common_voice_en_33000069.mp3,She was in charge of the house of St.,10,0,female_feminine,10,3996
3484,1464392,common_voice_en_33000146.mp3,He held that professorship until his retirement.,10,0,female_feminine,10,4968
3485,1464393,common_voice_en_33000149.mp3,They lived in Bridgeport before removing to New York City.,10,0,female_feminine,10,4608
3486,1464394,common_voice_en_33000150.mp3,She attended the Belfast School of Art.,10,0,female_feminine,10,3960
3487,1464395,common_voice_en_33000151.mp3,Blue coral is absent from the Phoenix Islands and the Line Islands.,10,0,female_feminine,10,5580
3488,1464099,common_voice_en_32886753.mp3,After the war the Imperial War Museum purchased some of his drawings.,10,0,female_feminine,10,7596
3489,1464397,common_voice_en_33000153.mp3,She also become the fifth wife and Royal Consort of King Gyeongjong of Goryeo.,10,0,female_feminine,10,7236
3490,1464398,common_voice_en_33000154.mp3,The league ranks third in the European league ranking table.,10,0,female_feminine,10,4716
3491,1464399,common_voice_en_33000157.mp3,They may be used in combat with other members of the same species.,10,0,female_feminine,10,5328
3492,1464400,common_voice_en_33000158.mp3,He played college football for the Oregon Ducks.,10,0,female_feminine,10,3960
3493,1464401,common_voice_en_33000159.mp3,"Then the ""Declaration"" was opened for signing to other people.",10,0,female_feminine,10,5436
3494,1464402,common_voice_en_33000160.mp3,Dubreuil also started to breed roses on his own.,10,0,female_feminine,10,5076
3495,1464403,common_voice_en_33000162.mp3,So it’s all about how we perceive someone versus how they actually are.,10,0,female_feminine,10,5580
3496,1464405,common_voice_en_33000166.mp3,Christian Eckes of Kyle Busch Motorsports would draw for the pole.,10,0,female_feminine,10,5940
3497,1464406,common_voice_en_33000167.mp3,White was active for the law society and sat on many committees.,10,0,female_feminine,10,4356
3498,1464408,common_voice_en_33000169.mp3,This was the first of two brick houses built by the Smiths.,10,0,female_feminine,10,4860
3499,1464409,common_voice_en_33000170.mp3,This extends round the whole shaft of the linga.,10,0,female_feminine,10,4500
3500,1464396,common_voice_en_33000152.mp3,Downs was also prominent in the early days of Australian rules football in Adelaide.,10,0,female_feminine,10,6876
3501,1530778,common_voice_en_32265047.mp3,This house gives Casa Condal the nickname to the whole.,12,2,female_feminine,10,5976
3502,1464347,common_voice_en_33000037.mp3,He was succeeded by Rabbi Fred Kazan.,10,0,female_feminine,10,4500
3503,1464348,common_voice_en_33000039.mp3,A little further downstream was Iron Mills.,10,0,female_feminine,10,4428
3504,1464349,common_voice_en_33000040.mp3,He represents his Constituency till date.,10,0,female_feminine,10,5076
3505,1464350,common_voice_en_33000043.mp3,So this season no one was declared Athenian champion.,10,0,female_feminine,10,5868
3506,1464351,common_voice_en_33000045.mp3,They can also be easily propagated with spores.,10,0,female_feminine,10,5076
3507,1464352,common_voice_en_33000047.mp3,He has four children and nine grandchildren with his first wife.,10,0,female_feminine,10,5616
3508,1464353,common_voice_en_33000048.mp3,United plans were disrupted by sweeping arrests.,10,0,female_feminine,10,5328
3509,1464354,common_voice_en_33000058.mp3,Sanskrit and foreign languages will also be given emphasis.,10,0,female_feminine,10,6300
3510,1464357,common_voice_en_33000067.mp3,It was an animated comedy created by Tom Snyder.,10,0,female_feminine,10,6300
3511,1464358,common_voice_en_33000068.mp3,Shamash was associated with palm trees.,10,0,female_feminine,10,4860
3512,1464373,common_voice_en_33000094.mp3,Usually his stories revolved around machines and vehicles in peril.,10,0,female_feminine,10,5940
3513,637837,common_voice_en_62499.mp3,The two men hurried back and found the cylinder still lying in the same position.,10,0,female_feminine,10,4680
3514,1464361,common_voice_en_33000071.mp3,Wepner disputes this.,10,0,female_feminine,10,3060
3515,1464362,common_voice_en_33000077.mp3,She pleaded guilty to eight and two that she denied were dropped.,10,0,female_feminine,10,6408
3516,1464363,common_voice_en_33000078.mp3,It includes the Tenexcalli and Barriga de Plata areas.,10,0,female_feminine,10,7128
3517,1464365,common_voice_en_33000080.mp3,This northern area of Quebec does not have passable roads.,10,0,female_feminine,10,5796
3518,1464366,common_voice_en_33000081.mp3,Some autobiographical details penetrate his paintings in seemingly unrelated connections.,10,0,female_feminine,10,7596
3519,1464368,common_voice_en_33000084.mp3,The ward is home to the Royal Bournemouth Hospital and Kings Park.,10,0,female_feminine,10,6408
3520,1464369,common_voice_en_33000085.mp3,The movie is distributed by Cinedigm Entertainment Group.,10,0,female_feminine,10,6120
3521,1464370,common_voice_en_33000086.mp3,The princess immediately stops crying and embraces John.,10,0,female_feminine,10,5220
3522,1150599,common_voice_en_26193.mp3,"I've learned things from the sheep, and I've learned things from crystal, he thought.",10,0,female_feminine,10,4176
3523,1464371,common_voice_en_33000092.mp3,The aircraft immediately returned to Atlanta and made an emergency landing.,10,0,female_feminine,10,6120
3524,1464372,common_voice_en_33000093.mp3,Dharmadasa lives in Kandy.,10,0,female_feminine,10,4428
3525,1464327,common_voice_en_32999985.mp3,Her papers are housed at the Schlesinger Library.,10,0,female_feminine,10,5868
3526,614448,common_voice_en_38598156.mp3,The House Bank functioned according to rules different from the laws governing deposit institutions.,10,0,female_feminine,10,5688
3527,614443,common_voice_en_38598130.mp3,That throw of was also a new world record.,10,0,female_feminine,10,3600
3528,614441,common_voice_en_38598107.mp3,It is a test flight and evaluation organisation.,10,0,female_feminine,10,3852
3529,614440,common_voice_en_38598059.mp3,They learned to observe it during their captivity in the East.,10,0,female_feminine,10,4140
3530,614436,common_voice_en_38597995.mp3,"He was a first-team All-American and finalist for ""College Player of the Year"".",10,0,female_feminine,10,6120
3531,1464427,common_voice_en_33054770.mp3,To the south were sidings that served Kirkliston Distillery.,10,0,female_feminine,10,7236
3532,1464428,common_voice_en_33054771.mp3,He assures Browne he will investigate the matter and returns to his office.,10,0,female_feminine,10,6048
3533,1464429,common_voice_en_33054774.mp3,Dorsal surface covered with long erect setae.,10,0,female_feminine,10,6300
3534,1464430,common_voice_en_33055391.mp3,He began writing poetry in middle school before later turning to prose.,10,0,female_feminine,10,6516
3535,614457,common_voice_en_38598256.mp3,"On other systems, the process may be quite different.",10,0,female_feminine,10,4176
3536,1464431,common_voice_en_33055392.mp3,Stuckey was the sole witness to testify for the Republicans.,10,0,female_feminine,10,5400
3537,1464411,common_voice_en_33000172.mp3,During this time Lansing had three children.,10,0,female_feminine,10,3780
3538,1464433,common_voice_en_33055394.mp3,Parts of Torney General Hospital are now the Desert Regional Medical Center.,10,0,female_feminine,10,8208
3539,1464434,common_voice_en_33055395.mp3,"The work is titled ""Border between Germany and France"".",10,0,female_feminine,10,4680
3540,1464437,common_voice_en_33055455.mp3,Marshall was also selected to voice the younger Kenshin during flashback scenes.,10,0,female_feminine,10,6408
3541,1464407,common_voice_en_33000168.mp3,She speaks Kaqchikel as well as Spanish and some Poqomam Mayan.,10,0,female_feminine,10,6156
3542,1464440,common_voice_en_33055828.mp3,Christ University won the overall championship.,10,0,female_feminine,10,5760
3543,1464443,common_voice_en_33055858.mp3,There were district councils within the regions.,10,0,female_feminine,10,4428
3544,1464445,common_voice_en_33055903.mp3,They are currently members of the and play at The Bowl.,10,0,female_feminine,10,5220
3545,1464446,common_voice_en_33055905.mp3,Beer chose each object for its unique pitch.,10,0,female_feminine,10,4860
3546,1464447,common_voice_en_33055907.mp3,Both these groups are listed as Scheduled Tribes by the Government of India.,10,0,female_feminine,10,6156
3547,290109,common_voice_en_520579.mp3,I was disappointed at this inanimate bulk.,10,0,female_feminine,10,4200
3548,1464448,common_voice_en_33055936.mp3,Mahesh was influenced by the virtues in his parents.,10,0,female_feminine,10,5400
3549,1464450,common_voice_en_33055938.mp3,He has received six Latin Grammy Awards as producer and songwriter.,10,0,female_feminine,10,5688
3550,1464432,common_voice_en_33055393.mp3,The team had no head coach.,10,0,female_feminine,10,3456
3551,1464412,common_voice_en_33000173.mp3,A fossil was named after her.,10,0,female_feminine,10,3060
3552,1464414,common_voice_en_33000180.mp3,His disciple Aristotle wrote the book Metaphysics.,10,0,female_feminine,10,6300
3553,1464415,common_voice_en_33000181.mp3,Different community projects were started to meet the need for water.,10,0,female_feminine,10,5220
3554,1464416,common_voice_en_33000182.mp3,The upper jaw is completely toothless apart from these two tusks.,10,0,female_feminine,10,5328
3555,1464417,common_voice_en_33000183.mp3,She still holds an Honorary Fellowship at the University of Edinburgh.,10,0,female_feminine,10,5148
3556,1464418,common_voice_en_33000186.mp3,This was in hopes to alienate them from their culture and royal identity.,10,0,female_feminine,10,5148
3557,1464420,common_voice_en_33054310.mp3,She performed six roles in Azerbaijani language.,10,0,female_feminine,10,5688
3558,1464421,common_voice_en_33054311.mp3,The acrobatic gymnastics competition took place at Akita City Gymnasium.,10,0,female_feminine,10,7020
3559,288750,common_voice_en_903.mp3,"As he did so, he talked with the monk about the tribal wars.",20,10,female_feminine,10,10296
3560,614482,common_voice_en_38598509.mp3,Bones Floro is the chef de mission of the Philippine delegation.,10,0,female_feminine,10,4428
3561,614480,common_voice_en_38598486.mp3,Superstitious rustics are wont to dance and leap high in spring.,10,0,female_feminine,10,5220
3562,614450,common_voice_en_38598177.mp3,It is to be on display at the Indiana Statehouse at all times.,10,0,female_feminine,10,5256
3563,614479,common_voice_en_38598484.mp3,Advanced techniques are needed to overcome noisy direct current environments.,10,0,female_feminine,10,5256
3564,1464391,common_voice_en_33000141.mp3,It is sparsely populated.,10,0,female_feminine,10,2736
3565,1464424,common_voice_en_33054314.mp3,The sectarian activities started to fire back.,10,0,female_feminine,10,4716
3566,1464425,common_voice_en_33054342.mp3,He and his wife Kara have three sons.,10,0,female_feminine,10,4176
3567,1464426,common_voice_en_33054344.mp3,"She and her sister compiled the ""Westminster Abbey Official Guide"".",10,0,female_feminine,10,6768
3568,614476,common_voice_en_38598454.mp3,"The female has dark brown upperparts, with buff wing spots and extensively grey-streaked underparts.",10,0,female_feminine,10,6228
3569,614471,common_voice_en_38598441.mp3,Kootingal has a Scout group in combination with the village of Moonbi.,10,0,female_feminine,10,4464
3570,614467,common_voice_en_38598424.mp3,Some Wolf-Rayet stars are surrounded by pinwheel nebulae.,10,0,female_feminine,10,4608
3571,614462,common_voice_en_38598336.mp3,"Of these, ""Light Surrounding You"" charted best, and became Evermore's first number one single.",10,0,female_feminine,10,6336
3572,614460,common_voice_en_38598285.mp3,"However, the treatment was more disciplinary than punitive.",10,0,female_feminine,10,4032
3573,614459,common_voice_en_38598282.mp3,"The album was mixed by Anthony ""Crucial Bunny"" Graham at Studio One, Jamaica.",10,0,female_feminine,10,5220
3574,614452,common_voice_en_38598206.mp3,This story may have been a factor in his selection as party boss.,10,0,female_feminine,10,4644
3575,820211,common_voice_en_18214380.mp3,"Kenneth reacted badly to the steroids, he's under observation for the next hour.",10,0,female_feminine,10,5616
3576,1464260,common_voice_en_32914421.mp3,"All credits are adapted from the liner notes of ""In Love"".",10,0,female_feminine,10,6768
3577,1464262,common_voice_en_32914423.mp3,It is found in western Colombia and Ecuador.,10,0,female_feminine,10,4356
3578,1464231,common_voice_en_32914133.mp3,Ngcobo was also the mayor of Ulundi.,10,0,female_feminine,10,4968
3579,1464264,common_voice_en_32914440.mp3,Hoadly never married and had no issue.,10,0,female_feminine,10,4608
3580,1464269,common_voice_en_32914458.mp3,There are four children from the marriage.,10,0,female_feminine,10,3888
3581,1464270,common_voice_en_32914459.mp3,The cover art for the game is by John Enright.,10,0,female_feminine,10,5436
3582,1464273,common_voice_en_32914477.mp3,Different subpopulations can fluctuate in abundance due to the action of wildfires.,10,0,female_feminine,10,7596
3583,1659363,common_voice_en_37947308.mp3,She taught elementary school for three years.,12,2,female_feminine,10,4716
3584,1464274,common_voice_en_32914478.mp3,All songs by Mannequin Pussy.,10,0,female_feminine,10,5256
3585,1464275,common_voice_en_32914479.mp3,The road was wide.,10,0,female_feminine,10,3276
3586,1464277,common_voice_en_32914481.mp3,He was the second son of Thomas de Multon and Sarah de Flete.,10,0,female_feminine,10,10368
3587,394408,common_voice_en_18829.mp3,Its lower end was still embedded.,12,2,female_feminine,10,3288
3588,1464282,common_voice_en_32914510.mp3,Each nation was limited to three riders.,10,0,female_feminine,10,4176
3589,1464285,common_voice_en_32914513.mp3,The Boston Police arrest Leo and those involved.,10,0,female_feminine,10,4608
3590,1464286,common_voice_en_32914514.mp3,There are currently no Kanawha River crossings in Arbuckle District.,10,0,female_feminine,10,8100
3591,1464287,common_voice_en_32914515.mp3,Usually cedars are found in areas of deciduous and mixed forest.,10,0,female_feminine,10,6840
3592,1464289,common_voice_en_32914529.mp3,The present holder is disputed.,10,0,female_feminine,10,3528
3593,1464290,common_voice_en_32914530.mp3,The venue of the championships is decided on an annual basis.,10,0,female_feminine,10,6300
3594,1464291,common_voice_en_32914531.mp3,One of their daughters is actress Melissa Roxburgh.,10,0,female_feminine,10,5076
3595,1464292,common_voice_en_32914532.mp3,The dominion of the Antichrist is announced and the Last Judgment after.,10,0,female_feminine,10,7200
3596,1464293,common_voice_en_32914561.mp3,Afrika Bambaataa appears on the album.,10,0,female_feminine,10,5220
3597,1464294,common_voice_en_32914562.mp3,He plays shooting guard position.,10,0,female_feminine,10,3420
3598,1464263,common_voice_en_32914439.mp3,Blankenship researches structural interventions and social determinants of health.,10,0,female_feminine,10,8928
3599,1464247,common_voice_en_32914385.mp3,He was the younger brother of renowned Mali Madhavan Nair.,10,0,female_feminine,10,5760
3600,1464227,common_voice_en_32914108.mp3,It is entirely in Carlton County.,10,0,female_feminine,10,4536
3601,1464228,common_voice_en_32914109.mp3,She also completed all three stages of Kandyan dancing at school times.,10,0,female_feminine,10,6336
3602,1464230,common_voice_en_32914132.mp3,I want to share my enthusiasm with them.,10,0,female_feminine,10,4788
3603,1464233,common_voice_en_32914369.mp3,He played for the Western Suburbs Magpies and Past Brothers.,10,0,female_feminine,10,6048
3604,1464234,common_voice_en_32914370.mp3,Winners are written in bold.,10,0,female_feminine,10,3600
3605,1464236,common_voice_en_32914372.mp3,Women were also admitted.,10,0,female_feminine,10,3348
3606,1464237,common_voice_en_32914373.mp3,The hand and foot imprints are not particularly distinct.,10,0,female_feminine,10,5688
3607,1464239,common_voice_en_32914376.mp3,"The place has been mentioned in Skanda Purana in the section of ""Manas Khanda"".",10,0,female_feminine,10,7236
3608,1464240,common_voice_en_32914378.mp3,Halling Church is located in Halling.,10,0,female_feminine,10,5616
3609,1464241,common_voice_en_32914379.mp3,Handles were sometimes present.,10,0,female_feminine,10,3600
3610,1464242,common_voice_en_32914380.mp3,The locality takes its name from the former railway station.,10,0,female_feminine,10,6120
3611,1464259,common_voice_en_32914420.mp3,Khan held an inherited position.,10,0,female_feminine,10,4356
3612,1464245,common_voice_en_32914383.mp3,"The worst performing team in the second ""Showpiece"" round is eliminated from the competition.",10,0,female_feminine,10,7596
3613,1464246,common_voice_en_32914384.mp3,It was based on the play by John Mortimer.,10,0,female_feminine,10,4536
3614,1464215,common_voice_en_32914039.mp3,The reasons they closed included money matters and insufficient utilization.,10,0,female_feminine,10,6336
3615,1464248,common_voice_en_32914386.mp3,The five sepals are joined at the base with lobes long.,10,0,female_feminine,10,4968
3616,1464250,common_voice_en_32914388.mp3,A music video was shot to accompany the song.,10,0,female_feminine,10,4500
3617,1464251,common_voice_en_32914389.mp3,It is more readily distinguishable by microscopic examination.,10,0,female_feminine,10,6336
3618,1464252,common_voice_en_32914390.mp3,This would be the second time in this tournament that these two teams met.,10,0,female_feminine,10,6336
3619,1464253,common_voice_en_32914391.mp3,"The collection includes ""On the Ning Nang Nong"".",10,0,female_feminine,10,6768
3620,1464254,common_voice_en_32914394.mp3,They range in shape and size from small and circular to large and oblong.,10,0,female_feminine,10,7056
3621,1464255,common_voice_en_32914405.mp3,The design was inspired by the grandeur of the Fairmont hotels.,10,0,female_feminine,10,5508
3622,1464256,common_voice_en_32914407.mp3,The Foundation Council may dismiss members of the management.,10,0,female_feminine,10,4896
3623,1464258,common_voice_en_32914419.mp3,It was the largest cinema in northern Germany.,10,0,female_feminine,10,5148
3624,1464243,common_voice_en_32914381.mp3,The administrator of Canada represents the Crown in right of the federal government.,10,0,female_feminine,10,7416
3625,1464295,common_voice_en_32914598.mp3,One of the main tributaries of river Ganga.,10,0,female_feminine,10,4140
3626,1658713,common_voice_en_37935292.mp3,Different types of pavements develop different cracks.,10,0,female_feminine,10,5616
3627,1464328,common_voice_en_32999986.mp3,Much of the upkeep of the mineral spring was overseen by these families.,10,0,female_feminine,10,6516
3628,1150454,common_voice_en_26048.mp3,none of this ha d made an impression on the boy.,10,0,female_feminine,10,3216
3629,1464332,common_voice_en_32999990.mp3,Then Third Army entered the Allied Hundred Days Offensive.,10,0,female_feminine,10,5940
3630,1464333,common_voice_en_32999993.mp3,Later in the year he played excellently at the Engadine Open in Switzerland.,10,0,female_feminine,10,8280
3631,1464334,common_voice_en_32999994.mp3,She went on to dance principal roles in other productions.,10,0,female_feminine,10,5328
3632,1660144,common_voice_en_37960391.mp3,This is a simplified example.,12,2,female_feminine,10,4140
3633,1464335,common_voice_en_32999995.mp3,It turned out to be her last show.,10,0,female_feminine,10,3708
3634,1464336,common_voice_en_32999996.mp3,William Talbot Handy and Dorothy Pauline Pleasant Handy.,10,0,female_feminine,10,6660
3635,1464338,common_voice_en_32999999.mp3,Tunzi is one of four sisters.,10,0,female_feminine,10,4356
3636,1464296,common_voice_en_32914600.mp3,Filey is considered to be the probable location of the port settlement.,10,0,female_feminine,10,6156
3637,1464341,common_voice_en_33000022.mp3,The Chalcolithic and Bronze Age feature bell beaker pottery and stone arrowheads.,10,0,female_feminine,10,6516
3638,1464342,common_voice_en_33000024.mp3,He attended Paul Laurence Dunbar High School in Lexington.,10,0,female_feminine,10,5148
3639,281085,common_voice_en_13768.mp3,It was the first time she had done that.,10,0,female_feminine,10,3480
3640,281087,common_voice_en_13770.mp3,"For every ten dead men among our enemies, you will receive a piece of gold.",10,0,female_feminine,10,6144
3641,281089,common_voice_en_13772.mp3,"Finally, after hours of waiting, the guard bade the boy enter.",11,1,female_feminine,10,5424
3642,281094,common_voice_en_13777.mp3,"You must not let up, even after having come so far, he continued.",11,1,female_feminine,10,5544
3643,1464344,common_voice_en_33000026.mp3,It mostly presents with motor and sensory symptoms.,10,0,female_feminine,10,4896
3644,863217,common_voice_en_37206585.mp3,"Nick was based in New York, Phil in Toronto and Shashi in Los Angeles.",12,2,female_feminine,10,5508
3645,394472,common_voice_en_49207.mp3,It's extremely suspicious that there's no information about brains that didn't come from a brain.,10,0,female_feminine,10,8352
3646,1464346,common_voice_en_33000036.mp3,Many plants collected by him were subsequently named in his honor.,10,0,female_feminine,10,6336
3647,394404,common_voice_en_18825.mp3,Dense clouds of smoke or dust can be seen through a powerful telescope.,10,0,female_feminine,10,6048
3648,394414,common_voice_en_18835.mp3,Most meteorites are more or less rounded.,10,0,female_feminine,10,4080
3649,1150472,common_voice_en_26066.mp3,"The desert was all sand in some stretches, and rocky in others.",10,0,female_feminine,10,4080
3650,1464297,common_voice_en_32914601.mp3,Political parties are also excluded.,10,0,female_feminine,10,3600
3651,1464298,common_voice_en_32914638.mp3,Ready ran unopposed in the Democratic primary.,10,0,female_feminine,10,5076
3652,1464299,common_voice_en_32914639.mp3,There are also other Romanian words that break other records within the language.,10,0,female_feminine,10,7560
3653,1464300,common_voice_en_32914641.mp3,His portrait characterizations were also inspired by the works of Heinrich Christoph Kolbe.,10,0,female_feminine,10,8496
3654,1464302,common_voice_en_32914673.mp3,Their work focuses on the Black British experience.,10,0,female_feminine,10,5148
3655,1464303,common_voice_en_32914674.mp3,The locomotive is still represented and honored in modern history.,10,0,female_feminine,10,6840
3656,1464304,common_voice_en_32914675.mp3,He went to college at Oklahoma State and played linebacker.,10,0,female_feminine,10,5256
3657,1150375,common_voice_en_25969.mp3,The same hand that had brandished the sword now held a whip.,10,0,female_feminine,10,4056
3658,1464307,common_voice_en_32914698.mp3,She started playing table tennis aged eleven.,10,0,female_feminine,10,3996
3659,1464309,common_voice_en_32914700.mp3,She is also the youngest certified female marketing agent in baseball.,10,0,female_feminine,10,5868
3660,1464310,common_voice_en_32914701.mp3,The gold rushes ended.,10,0,female_feminine,10,3456
3661,1464326,common_voice_en_32999984.mp3,Hungerford.,10,0,female_feminine,10,3060
3662,1464312,common_voice_en_32914752.mp3,Some streets and squares in Istrian towns are named after him.,10,0,female_feminine,10,5688
3663,1464313,common_voice_en_32914757.mp3,Add adverts,10,0,female_feminine,10,4068
3664,1464314,common_voice_en_32999972.mp3,We can do this.,10,0,female_feminine,10,3276
3665,1464315,common_voice_en_32999973.mp3,Sunde was also prone to extreme seasickness.,10,0,female_feminine,10,4968
3666,1464316,common_voice_en_32999974.mp3,The Philippine Embassy in Santiago is currently headed by Ambassador Ma.,10,0,female_feminine,10,7128
3667,1464319,common_voice_en_32999977.mp3,She is an Andrew Carnegie fellow.,10,0,female_feminine,10,3960
3668,1464320,common_voice_en_32999978.mp3,The bed of the river is clay and mud along almost its entire length.,10,0,female_feminine,10,7236
3669,1464321,common_voice_en_32999979.mp3,Kim has never often appeared in front of the general public.,10,0,female_feminine,10,6480
3670,1464322,common_voice_en_32999980.mp3,Both had been imprisoned by the United States.,10,0,female_feminine,10,4896
3671,1464323,common_voice_en_32999981.mp3,Nikki Slade Robinson has two daughters and lives near Opotiki.,10,0,female_feminine,10,6876
3672,1464324,common_voice_en_32999982.mp3,She also holds an honorary doctorate from the University of Edinburgh.,10,0,female_feminine,10,6876
3673,1464325,common_voice_en_32999983.mp3,Phu Quoc island was also hit by serious floods.,10,0,female_feminine,10,5796
3674,1464279,common_voice_en_32914494.mp3,His title and responsibilities changed with the breakup of Yugoslavia.,10,0,female_feminine,10,6408
3675,1463758,common_voice_en_32388891.mp3,It is produced by Frames Production India.,10,0,female_feminine,10,6048
3676,1463756,common_voice_en_32388889.mp3,She also noted the problem of economic violence for widows in rural communities.,10,0,female_feminine,10,8280
3677,1463755,common_voice_en_32388888.mp3,The event was broadcast by Eurosport.,10,0,female_feminine,10,5436
3678,944588,common_voice_en_32836605.mp3,She was married to actor Emil Hossu.,10,0,female_feminine,10,3708
3679,1463754,common_voice_en_32388887.mp3,He specializes in the study of neutrinos.,10,0,female_feminine,10,6588
3680,1463752,common_voice_en_32371416.mp3,She has spoken out about her struggle with mental health issues.,10,0,female_feminine,10,5940
3681,1463742,common_voice_en_32371398.mp3,These operations resulted in the detainment of many members of the Serb population.,10,0,female_feminine,10,9648
3682,1463741,common_voice_en_32365082.mp3,Other towns and villages in the shire included Stuart Town.,10,0,female_feminine,10,6156
3683,1463740,common_voice_en_32365081.mp3,Aric Almirola would win.,10,0,female_feminine,10,6120
3684,1463739,common_voice_en_32365080.mp3,This remains the largest margin of victory in Canadian Classique history.,10,0,female_feminine,10,5868
3685,1463738,common_voice_en_32365079.mp3,Some schools also made cuts to student lunch break periods and to holidays.,10,0,female_feminine,10,7020
3686,1463737,common_voice_en_32365078.mp3,It is presented along with other period rolling stock at the site.,10,0,female_feminine,10,6660
3687,1464451,common_voice_en_33055939.mp3,She took the interest on the sport of squash at the age of eight.,10,0,female_feminine,10,6120
3688,1463735,common_voice_en_32365064.mp3,The parish contains the village of Drayton Bassett and the surrounding area.,10,0,female_feminine,10,6408
3689,1463734,common_voice_en_32365063.mp3,Banks.,10,0,female_feminine,10,3456
3690,1463910,common_voice_en_32644520.mp3,Wall Street Journal.,10,0,female_feminine,10,4176
3691,944590,common_voice_en_32836861.mp3,Residents of Luynes did not approve of anarchist boarders joining the colony.,10,0,female_feminine,10,5868
3692,1463700,common_voice_en_32359862.mp3,The southern portion of the region then terminated at the Arch of Augustus.,10,0,female_feminine,10,6768
3693,1463731,common_voice_en_32365059.mp3,She grew up in Bordeaux.,10,0,female_feminine,10,3780
3694,944591,common_voice_en_32836862.mp3,The area is served by the Orient post office.,10,0,female_feminine,10,4176
3695,1463728,common_voice_en_32365056.mp3,The compound is used mainly in wheat but also in pasture.,10,0,female_feminine,10,6048
3696,1463727,common_voice_en_32365032.mp3,To the southeast was Whifflet High Level signal box.,10,0,female_feminine,10,5868
3697,1463726,common_voice_en_32365030.mp3,Its flowers are unisexual.,10,0,female_feminine,10,4356
3698,1463725,common_voice_en_32365028.mp3,Post production on the film was expected to wrap by early September.,10,0,female_feminine,10,6840
3699,1463724,common_voice_en_32365027.mp3,She travelled to Chechnya and Dagestan several times for her human rights work.,10,0,female_feminine,10,8460
3700,1463736,common_voice_en_32365065.mp3,"The name ""Gorenje"" is shared by several settlements in Slovenia.",10,0,female_feminine,10,7020
3701,1463793,common_voice_en_32389174.mp3,It was named for the Chatham Strait.,10,0,female_feminine,10,4140
3702,1463792,common_voice_en_32389170.mp3,Agriculture is the main source of income for this village.,10,0,female_feminine,10,6876
3703,1463791,common_voice_en_32389168.mp3,Tuttle has been very influential in his field.,10,0,female_feminine,10,5148
3704,1463790,common_voice_en_32389151.mp3,Another amendment will tighten the requirements for presidential candidates.,10,0,female_feminine,10,6588
3705,1463789,common_voice_en_32389150.mp3,"Chan was dubbed ""The Singing Bishop"" due to his penchant for music.",10,0,female_feminine,10,8028
3706,713362,common_voice_en_20285301.mp3,Residents are zoned to schools in the Fairfax County Public Schools.,10,0,female_feminine,10,4920
3707,1463788,common_voice_en_32389149.mp3,The project was completed before the start of Speedweeks.,10,0,female_feminine,10,5940
3708,1463787,common_voice_en_32389148.mp3,One of them involved the removal of the spleen after which several animals survived.,10,0,female_feminine,10,7956
3709,1463786,common_voice_en_32389147.mp3,The scientific fields he is most actively involved in are biomechanics and interventional cardiology.,10,0,female_feminine,10,10008
3710,1463784,common_voice_en_32389124.mp3,These awards encouraged him to visit America.,10,0,female_feminine,10,5688
3711,1463783,common_voice_en_32389123.mp3,Wankhede is also facing bribery charges.,10,0,female_feminine,10,4716
3712,1463782,common_voice_en_32389122.mp3,A modest success.,10,0,female_feminine,10,3996
3713,1463760,common_voice_en_32388964.mp3,Speak to me.,10,0,female_feminine,10,2988
3714,1463748,common_voice_en_32371412.mp3,He is the eldest son of producer Wajahat Rauf.,10,0,female_feminine,10,6660
3715,1463779,common_voice_en_32389112.mp3,The peak is just one mile outside the park boundary.,10,0,female_feminine,10,5580
3716,1463778,common_voice_en_32389111.mp3,He promised to forget the thick rivalry between Persija and Persib Bandung.,10,0,female_feminine,10,8820
3717,713366,common_voice_en_20285330.mp3,"In addition, the Giants considered signing him but eventually signed Anthony Wright instead.",10,0,female_feminine,10,5760
3718,1463776,common_voice_en_32389088.mp3,Abu Hafs Umar fled Tunis but was captured near Gabes and executed in August.,10,0,female_feminine,10,9720
3719,1463774,common_voice_en_32389085.mp3,The name of the Yazoo City home minor league ballpark is not referenced.,10,0,female_feminine,10,7308
3720,1463773,common_voice_en_32389084.mp3,Kyle Luu was the stylist.,10,0,female_feminine,10,5220
3721,1463772,common_voice_en_32389055.mp3,He studied at Harrow School and the Royal Military Academy in Woolwich.,10,0,female_feminine,10,7380
3722,1463771,common_voice_en_32389054.mp3,"The album was supported by the single ""For the Men"".",10,0,female_feminine,10,5616
3723,1463769,common_voice_en_32389052.mp3,It is demersal.,10,0,female_feminine,10,2916
3724,1463766,common_voice_en_32389001.mp3,The aerobic gymnastics competition took place at Akita City Gymnasium.,10,0,female_feminine,10,8460
3725,1463765,common_voice_en_32389000.mp3,It is one of the largest and best explored caves in the Sudetes.,10,0,female_feminine,10,7020
3726,1463763,common_voice_en_32388967.mp3,He is married to Tracee Hynes and lives in South Boston.,10,0,female_feminine,10,6408
3727,1463781,common_voice_en_32389114.mp3,He urged Republicans to instead abstain from voting in the congressional race.,10,0,female_feminine,10,7488
3728,1463691,common_voice_en_32359806.mp3,She is the eldest daughter of politician and journalist Carlos Palenque (El Compadre).,10,0,female_feminine,10,10008
3729,1463690,common_voice_en_32359790.mp3,The fruit is sometimes sold for food.,10,0,female_feminine,10,4500
3730,1463689,common_voice_en_32359789.mp3,She represents the Ngora District.,10,0,female_feminine,10,6660
3731,1463688,common_voice_en_32359787.mp3,It stars Alexandra Daddario and Diego Boneta.,10,0,female_feminine,10,6300
3732,1463687,common_voice_en_32359786.mp3,York spoke of the need for more acting roles for people in wheelchairs.,10,0,female_feminine,10,7596
3733,1463686,common_voice_en_32359780.mp3,Uranium and other mined ore deposits are principally concentrated in the Moss Back Member.,10,0,female_feminine,10,9216
3734,1463685,common_voice_en_32359779.mp3,Coulibaly has represented Mali in several international competitions.,10,0,female_feminine,10,6660
3735,1463683,common_voice_en_32359777.mp3,Discussions for the Conference did not get off the ground.,10,0,female_feminine,10,5868
3736,1463682,common_voice_en_32359776.mp3,Antennal club slightly longer than scape.,10,0,female_feminine,10,5940
3737,1463681,common_voice_en_32359774.mp3,Batuk reached there and tried to save Anirudh but to no avail.,10,0,female_feminine,10,7848
3738,1463680,common_voice_en_32359773.mp3,They wanted to take to the streets and march.,10,0,female_feminine,10,4968
3739,1463679,common_voice_en_32359772.mp3,The only information about his life is included in his books.,10,0,female_feminine,10,6660
3740,1463723,common_voice_en_32365026.mp3,There he took lessons in musical composition under Michael Traugott Pfeiffer.,10,0,female_feminine,10,9036
3741,1463677,common_voice_en_32359755.mp3,"The project has also received criticism for promoting the ""Christian heritage"" of the state.",10,0,female_feminine,10,8100
3742,1463675,common_voice_en_32359752.mp3,He was an unaccompanied minor and became an undocumented migrant in the United States.,10,0,female_feminine,10,8496
3743,1463674,common_voice_en_32359751.mp3,Dairy and meat are allowed in small amounts.,10,0,female_feminine,10,5940
3744,1463673,common_voice_en_32359743.mp3,The winner for men was Jakob Schubert and for women was Jessica Pilz.,10,0,female_feminine,10,7956
3745,1463672,common_voice_en_32359742.mp3,She took her oath in Punjabi as well as English.,10,0,female_feminine,10,5688
3746,1463671,common_voice_en_32359740.mp3,Current public views on nanotechnology development in the agricultural industry are mixed.,10,0,female_feminine,10,9000
3747,1463670,common_voice_en_32359739.mp3,Troops from San Diego came to the camp for training for two weeks.,10,0,female_feminine,10,5400
3748,1463669,common_voice_en_32359725.mp3,Only the petals are eaten.,10,0,female_feminine,10,3888
3749,1463667,common_voice_en_32359722.mp3,The Cosmos finished second in the competition behind Detroit City.,10,0,female_feminine,10,6048
3750,1463666,common_voice_en_32359720.mp3,He is the son of the former professional footballer Walter Stamm.,10,0,female_feminine,10,6768
3751,944596,common_voice_en_32836897.mp3,She transferred her registry to Liverpool.,10,0,female_feminine,10,3888
3752,944597,common_voice_en_32836898.mp3,It is surrounded by the Rio Grande National Forest.,10,0,female_feminine,10,4248
3753,944630,common_voice_en_33393688.mp3,It is bordered to the west by Inglenook.,10,0,female_feminine,10,3960
3754,1463678,common_voice_en_32359771.mp3,That is if the old gun would even be ready fire before getting destroyed.,10,0,female_feminine,10,7488
3755,1463722,common_voice_en_32360028.mp3,Later she competed in ballroom dancing.,10,0,female_feminine,10,4140
3756,1463721,common_voice_en_32360027.mp3,Mass and liturgy were conducted in English.,10,0,female_feminine,10,4896
3757,1463719,common_voice_en_32360025.mp3,Lateral antennae present.,10,0,female_feminine,10,4248
3758,1463718,common_voice_en_32360024.mp3,"He also served as an actor in the movie ""One Hamlet Less"".",10,0,female_feminine,10,6876
3759,1463717,common_voice_en_32360011.mp3,The hymn also appears in many songbooks.,10,0,female_feminine,10,7740
3760,1463684,common_voice_en_32359778.mp3,Known for her geometric paintings that invoke pioneer quilts and Mormon culture.,10,0,female_feminine,10,8028
3761,944594,common_voice_en_32836895.mp3,Eventually she achieved the rank of Airman Second Class.,10,0,female_feminine,10,4716
3762,1463715,common_voice_en_32360009.mp3,He is of Miao ethnicity.,10,0,female_feminine,10,4968
3763,1463714,common_voice_en_32360008.mp3,Proper signalling had to be provided for the passenger service.,10,0,female_feminine,10,5580
3764,1463713,common_voice_en_32360007.mp3,He also taught music to many students.,10,0,female_feminine,10,4680
3765,1463712,common_voice_en_32359931.mp3,She became professor.,10,0,female_feminine,10,3060
3766,1463709,common_voice_en_32359927.mp3,Loh practiced family medicine in Brampton before specializing in public health.,10,0,female_feminine,10,7560
3767,1463692,common_voice_en_32359807.mp3,His name is sometimes written as Hudson.,10,0,female_feminine,10,5148
3768,1463707,common_voice_en_32359899.mp3,It straddles the boarder between the city of Richmond and Henrico County.,10,0,female_feminine,10,7128
3769,1463705,common_voice_en_32359896.mp3,The film was shot in Los Angeles and Monte Carlo.,10,0,female_feminine,10,5796
3770,944595,common_voice_en_32836896.mp3,The climate of the ecoregion is tropical and humid.,10,0,female_feminine,10,4356
3771,1463703,common_voice_en_32359865.mp3,"This staircase is described by Nikolaus Pevsner as ""exceptional"".",10,0,female_feminine,10,5940
3772,1463702,common_voice_en_32359864.mp3,Shaw was born in York to Donovan and Mona.,10,0,female_feminine,10,5580
3773,1463701,common_voice_en_32359863.mp3,"The word ""ocean"" is often used interchangeably with ""sea"" in American English.",10,0,female_feminine,10,9396
3774,1463668,common_voice_en_32359723.mp3,Streatfeild also held other public appointments.,10,0,female_feminine,10,4860
3775,1463698,common_voice_en_32359839.mp3,The factory left Saracen Street and moved to Cumbernauld.,10,0,female_feminine,10,5688
3776,1463697,common_voice_en_32359838.mp3,Starina is the nearest rural locality.,10,0,female_feminine,10,5076
3777,1463696,common_voice_en_32359837.mp3,He was also the topscorer of the match with three goals.,10,0,female_feminine,10,5796
3778,1463695,common_voice_en_32359836.mp3,Every students possess the right to vote and stand for election.,10,0,female_feminine,10,6408
3779,1463694,common_voice_en_32359809.mp3,The Naval Air Systems Command is organizationally aligned to the Chief of Naval Operations.,10,0,female_feminine,10,8748
3780,1463693,common_voice_en_32359808.mp3,Her other productions include editing productions for Lifetime and local filmmakers.,10,0,female_feminine,10,7056
3781,1463708,common_voice_en_32359900.mp3,It followed military rather than civilian procedures.,10,0,female_feminine,10,7128
3782,1463893,common_voice_en_32644186.mp3,Dissolution allowed these nuns to move to other convents.,10,0,female_feminine,10,7056
3783,944581,common_voice_en_32836551.mp3,The remainder of the season was cancelled due to the pandemic.,10,0,female_feminine,10,4068
3784,944614,common_voice_en_32837016.mp3,Books were banned for criticizing Gandhi and other important Indian historical figures.,10,0,female_feminine,10,6696
3785,1463891,common_voice_en_32564255.mp3,He studied metal processing engineering at Kim Chaek University of Technology.,10,0,female_feminine,10,6408
3786,1463890,common_voice_en_32564254.mp3,Piazza was born in Michigan and attended Central Michigan University.,10,0,female_feminine,10,6336
3787,1463889,common_voice_en_32564253.mp3,Photos also showed waves ponding on nearby sidewalks and roads.,10,0,female_feminine,10,6048
3788,1463888,common_voice_en_32564252.mp3,Neutral hydrogen has been detected against the galactic nucleus.,10,0,female_feminine,10,6588
3789,1463885,common_voice_en_32564182.mp3,The winged petioles are sheathing at the base.,10,0,female_feminine,10,4716
3790,1463882,common_voice_en_32564111.mp3,Whitby gained his cricket blue in his freshman year.,10,0,female_feminine,10,5148
3791,1463881,common_voice_en_32564109.mp3,Player salaries were published in the local newspaper along with team receipts.,10,0,female_feminine,10,7560
3792,1463844,common_voice_en_32389435.mp3,"I think ""Crooked Machine"" is one of his greatest achievements so far.",10,0,female_feminine,10,5688
3793,1657609,common_voice_en_37912776.mp3,All these games were played either at Oxford or Cambridge.,10,0,female_feminine,10,5796
3794,1463764,common_voice_en_32388998.mp3,They collaborated because they are both from musical theatre backgrounds.,10,0,female_feminine,10,6876
3795,1463876,common_voice_en_32534497.mp3,Dennis helps Andrea prepare for auditions and they become good friends.,10,0,female_feminine,10,5760
3796,1463874,common_voice_en_32534495.mp3,Henry Seeley worked on the production of the album.,10,0,female_feminine,10,5040
3797,1463873,common_voice_en_32534493.mp3,Smylie was married to Mamie Warren.,10,0,female_feminine,10,5940
3798,944615,common_voice_en_32837017.mp3,You just need to drink the right dope.,10,0,female_feminine,10,3240
3799,944584,common_voice_en_32836601.mp3,The ship was named after the toothed whale.,10,0,female_feminine,10,3348
3800,1463872,common_voice_en_32534492.mp3,The plot follows two interconnected timelines.,10,0,female_feminine,10,5220
3801,1463869,common_voice_en_32534489.mp3,Beck was also an influence on contemporary artist Gary Yazzie.,15,5,female_feminine,10,5040
3802,1463868,common_voice_en_32534487.mp3,All credits adapted from Tidal.,10,0,female_feminine,10,3420
3803,1463866,common_voice_en_32534482.mp3,He adopted the name and arms of Lascelles.,10,0,female_feminine,10,6768
3804,1463864,common_voice_en_32534479.mp3,The winners also dominate the losers.,10,0,female_feminine,10,4860
3805,1463828,common_voice_en_32389392.mp3,It was met with acclaim from music critics.,10,0,female_feminine,10,4248
3806,1463862,common_voice_en_32534476.mp3,The Reds won multiple titles in the semi–pro Lake Shore League.,10,0,female_feminine,10,5400
3807,1463877,common_voice_en_32534498.mp3,It serves as the historical and landmark society for the Greater Roslyn area.,10,0,female_feminine,10,9036
3808,1463908,common_voice_en_32644498.mp3,The survey is the longest continuous record of economists expectations.,10,0,female_feminine,10,7560
3809,944576,common_voice_en_32836497.mp3,The Mayo and the Yaqui held adjacent territories.,10,0,female_feminine,10,4176
3810,944575,common_voice_en_32836496.mp3,He built the first Mooney airplane.,10,0,female_feminine,10,3240
3811,944574,common_voice_en_32836457.mp3,"Arthur Kidson reports that Neville ""did much for the town"".",10,0,female_feminine,10,4428
3812,944573,common_voice_en_32836456.mp3,It has been cited as the first crossover.,10,0,female_feminine,10,3996
3813,944572,common_voice_en_32836455.mp3,It was the largest shoe manufacturing business of its day in the Nordics.,10,0,female_feminine,10,5436
3814,944571,common_voice_en_32836454.mp3,A street in Los Angeles was named for him.,10,0,female_feminine,10,3996
3815,1463907,common_voice_en_32644497.mp3,The church has three entrances.,10,0,female_feminine,10,4176
3816,944568,common_voice_en_32836421.mp3,Triller accounts can be made either public or private.,10,0,female_feminine,10,4356
3817,944599,common_voice_en_32836930.mp3,A large plot of land was acquired by the master builder Johan Martin Quist.,10,0,female_feminine,10,5796
3818,944598,common_voice_en_32836899.mp3,Her turbine drove the same propeller as her piston engine.,10,0,female_feminine,10,4536
3819,944565,common_voice_en_32836380.mp3,The Russian court ignored her request.,10,0,female_feminine,10,3348
3820,1463863,common_voice_en_32534478.mp3,Arjun is shocked and apologizes and then tells her how much he loved her.,10,0,female_feminine,10,6336
3821,944564,common_voice_en_32836379.mp3,She is the first woman to lead this ministry.,10,0,female_feminine,10,3780
3822,944563,common_voice_en_32836378.mp3,She was not known to have any formal engineering qualifications.,10,0,female_feminine,10,4680
3823,944562,common_voice_en_32836377.mp3,He published important articles on Ammianus Marcellinus and Constantine.,10,0,female_feminine,10,6048
3824,1463905,common_voice_en_32644495.mp3,The teams met during seven of the ten Series tournaments.,10,0,female_feminine,10,5148
3825,1463904,common_voice_en_32644469.mp3,It features guest appearances from Marta and Oh Land.,10,0,female_feminine,10,6660
3826,1463903,common_voice_en_32644467.mp3,The new spire was high.,10,0,female_feminine,10,4428
3827,944580,common_voice_en_32836550.mp3,She is the eldest daughter of four.,10,0,female_feminine,10,2988
3828,1463900,common_voice_en_32644461.mp3,Pedersen is widowed and has three children.,10,0,female_feminine,10,5256
3829,1463899,common_voice_en_32644424.mp3,She sustained serious injuries that resulted in one of her legs being amputated.,10,0,female_feminine,10,8856
3830,944583,common_voice_en_32836553.mp3,Her doctoral thesis was advised by Jure Leskovec.,10,0,female_feminine,10,4500
3831,1463898,common_voice_en_32644422.mp3,Edward Michael Smith was the master on this voyage.,10,0,female_feminine,10,6876
3832,1463897,common_voice_en_32644421.mp3,The park is mostly in the rain shadow of the Sierra Madre Oriental.,10,0,female_feminine,10,7848
3833,1463896,common_voice_en_32644190.mp3,It lays spherical eggs of about diameter.,10,0,female_feminine,10,6588
3834,1463906,common_voice_en_32644496.mp3,She represents the towns of Shrewsbury and Westborough.,10,0,female_feminine,10,6228
3835,1463822,common_voice_en_32389378.mp3,It is located in the Business Improvement Area of South Granville.,10,0,female_feminine,10,5796
3836,944567,common_voice_en_32836419.mp3,The tense situation in Shanghai that day escalated into the first Shanghai incident.,10,0,female_feminine,10,6588
3837,944566,common_voice_en_32836418.mp3,Aakash gets into street fight that drags him in the jail.,10,0,female_feminine,10,5040
3838,713346,common_voice_en_20285210.mp3,I don’t love you!,10,0,female_feminine,10,3672
3839,1463820,common_voice_en_32389308.mp3,Former New York Yankees star Whitey Ford was the first league commissioner.,10,0,female_feminine,10,7776
3840,944586,common_voice_en_32836603.mp3,He and his brother Domenico initially studied with Marco Ricci in Venice.,10,0,female_feminine,10,5688
3841,1463819,common_voice_en_32389307.mp3,Bobby Evans continued to add to his tally of Welsh caps.,10,0,female_feminine,10,5616
3842,1463818,common_voice_en_32389306.mp3,The brigade took part in no further actions for the remainder of the war.,10,0,female_feminine,10,6408
3843,1463817,common_voice_en_32389305.mp3,Salim and Carrizo have two children.,10,0,female_feminine,10,4608
3844,1463816,common_voice_en_32389291.mp3,There are no large settlements on the lake.,10,0,female_feminine,10,3960
3845,1463815,common_voice_en_32389290.mp3,The album was promoted by seven singles.,10,0,female_feminine,10,4608
3846,1463814,common_voice_en_32389289.mp3,Lower Florence Lake is further down the slope past Upper Florence lake.,10,0,female_feminine,10,6516
3847,1463861,common_voice_en_32534475.mp3,He is married and has one son and one daughter.,10,0,female_feminine,10,4716
3848,1463780,common_voice_en_32389113.mp3,This was followed by three straight birdies.,10,0,female_feminine,10,5616
3849,1463810,common_voice_en_32389265.mp3,"Morty himself was described by the police and news as an """"Akira"" boy"".",10,0,female_feminine,10,7776
3850,1463809,common_voice_en_32389264.mp3,"The name ""Monarch"" comes from nearby Monarch Ridge and the community of Monarch.",10,0,female_feminine,10,7560
3851,1463808,common_voice_en_32389263.mp3,"Rocky Wood describes ""For the Birds"" as ""very casual"" in tone.",10,0,female_feminine,10,7560
3852,1463806,common_voice_en_32389246.mp3,Dorsum yellow to dark yellowish brown.,10,0,female_feminine,10,5580
3853,1463805,common_voice_en_32389245.mp3,He was survived by Elizabeth Said.,10,0,female_feminine,10,5076
3854,1463804,common_voice_en_32389244.mp3,The island of Gizo lies further west in the Vella Gulf.,10,0,female_feminine,10,6516
3855,1463803,common_voice_en_32389242.mp3,A now closed copper mine is located in the wilderness.,10,0,female_feminine,10,5616
3856,1463802,common_voice_en_32389232.mp3,The museum has hitching rails on the outside of the saloon doors.,10,0,female_feminine,10,6516
3857,1463801,common_voice_en_32389229.mp3,It is the second phone to be released in the series.,10,0,female_feminine,10,5436
3858,1463800,common_voice_en_32389228.mp3,He was also an avid collector.,10,0,female_feminine,10,4500
3859,1463799,common_voice_en_32389227.mp3,Viticulture and mixed farming are still the main agricultural activities there.,10,0,female_feminine,10,7128
3860,1463797,common_voice_en_32389214.mp3,Volta Redonda and Olaria were relegated.,10,0,female_feminine,10,6048
3861,1463813,common_voice_en_32389288.mp3,She became the first Syracuse University mathematician to win this honor.,10,0,female_feminine,10,6516
3862,1463860,common_voice_en_32534474.mp3,It disrupted the growth and changed the ecosystem of the area.,10,0,female_feminine,10,5328
3863,1463858,common_voice_en_32534472.mp3,Bill Te Whata began playing rugby on the East Coast of the North Island.,10,0,female_feminine,10,5148
3864,1463856,common_voice_en_32534470.mp3,The album was reviewed positively in later years.,10,0,female_feminine,10,6336
3865,1463854,common_voice_en_32534467.mp3,"The name sometimes is written ""Surveyors Run"".",10,0,female_feminine,10,6480
3866,1463853,common_voice_en_32534466.mp3,Burges was charged over this incident.,10,0,female_feminine,10,4320
3867,1463849,common_voice_en_32389470.mp3,He also continued to own the house.,10,0,female_feminine,10,4176
3868,1463848,common_voice_en_32389454.mp3,He was replaced by Blake Austin.,10,0,female_feminine,10,4140
3869,1463847,common_voice_en_32389453.mp3,This trail can also be accessed from the Pine Lake Campground.,10,0,female_feminine,10,5868
3870,1463846,common_voice_en_32389437.mp3,It is in extreme east of Buta Territory.,10,0,female_feminine,10,4860
3871,1463845,common_voice_en_32389436.mp3,The shield is crowned with the ducal hat of Styria.,10,0,female_feminine,10,5328
3872,1463812,common_voice_en_32389287.mp3,The amendment changed the state constitution to allow recall elections of Illinois governors.,10,0,female_feminine,10,8208
3873,713342,common_voice_en_20285206.mp3,The new governorate existed for less than ten years.,10,0,female_feminine,10,5352
3874,1463823,common_voice_en_32389379.mp3,He was expelled from Nigeria along with the other Spiritans and returned to Ireland.,10,0,female_feminine,10,7596
3875,1463842,common_voice_en_32389433.mp3,No investigation has been launched to find out who was responsible for the shooting.,10,0,female_feminine,10,6336
3876,1463840,common_voice_en_32389431.mp3,The southernmost segment plunges in three massive steps.,10,0,female_feminine,10,5940
3877,1463837,common_voice_en_32389421.mp3,It was also nicknamed Misericordia Sunday and Good Shepherd Sunday.,10,0,female_feminine,10,6300
3878,1463836,common_voice_en_32389416.mp3,The inscription provides the earliest known names of females victors in non equestrian sports.,10,0,female_feminine,10,7956
3879,1463835,common_voice_en_32389415.mp3,He was assigned to occupy the position of Minister of Justice several times.,10,0,female_feminine,10,7020
3880,1463833,common_voice_en_32389413.mp3,"Again ""Dunvegan Castle"" detached to patrol and then return to Dakar.",10,0,female_feminine,10,8208
3881,1463832,common_voice_en_32389407.mp3,"The core of this group later became the """"Vityaz"""" unit.",10,0,female_feminine,10,6300
3882,1463830,common_voice_en_32389404.mp3,She was particularly interested in the weather changes over the Pennines.,10,0,female_feminine,10,6300
3883,1463829,common_voice_en_32389403.mp3,It can be used for soloing instead of regular jazz minor.,10,0,female_feminine,10,5616
3884,1463796,common_voice_en_32389213.mp3,He was particularly interested in dogmatic problems and practical theology.,10,0,female_feminine,10,7560
3885,1463826,common_voice_en_32389388.mp3,Leaves are alternate and glabrous.,10,0,female_feminine,10,4896
3886,1463825,common_voice_en_32389381.mp3,Members of the classification include money launderers and drug traffickers.,10,0,female_feminine,10,6300
3887,1463824,common_voice_en_32389380.mp3,The judicial procedure was opened by the National Audience.,10,0,female_feminine,10,6048
3888,1463843,common_voice_en_32389434.mp3,The show ran for four seasons.,10,0,female_feminine,10,3708
3889,1464013,common_voice_en_32858315.mp3,Jayamanne informed Deraniyagala to meet him after finishing school times.,10,0,female_feminine,10,7956
3890,1464014,common_voice_en_32858316.mp3,Some argue this placed them at the top of the league.,10,0,female_feminine,10,5148
3891,1464016,common_voice_en_32858318.mp3,The club has built new clubhouse facilities.,10,0,female_feminine,10,5076
3892,1464017,common_voice_en_32858335.mp3,She applied for medical hardship and gained another year of eligibility.,10,0,female_feminine,10,7236
3893,1464018,common_voice_en_32858336.mp3,The house stayed in the Benton family for six generations.,10,0,female_feminine,10,8568
3894,1464019,common_voice_en_32858337.mp3,Manas and Vaidehi join her father’s company.,10,0,female_feminine,10,6588
3895,1464020,common_voice_en_32858338.mp3,Among the important commodities it produced is coal.,10,0,female_feminine,10,5436
3896,1464021,common_voice_en_32858339.mp3,Alwan studies maternal and child health focusing on obesity and birth outcomes.,10,0,female_feminine,10,8280
3897,1464022,common_voice_en_32858343.mp3,Maksim Yegorov is married.,10,0,female_feminine,10,4680
3898,1463991,common_voice_en_32857239.mp3,His request was granted and assistant Mick Durham was named interim head coach.,10,0,female_feminine,10,7308
3899,1464024,common_voice_en_32858345.mp3,Foerster’s work has been exhibited in museums and galleries internationally.,10,0,female_feminine,10,8316
3900,1464026,common_voice_en_32858347.mp3,He studied at the seminaries in Montalto delle Marche and Fano.,10,0,female_feminine,10,7056
3901,944631,common_voice_en_33393689.mp3,Multiple lawsuits have already been filed.,10,0,female_feminine,10,3780
3902,1464028,common_voice_en_32858364.mp3,Its center of diversity is the Balkans.,10,0,female_feminine,10,6048
3903,1657105,common_voice_en_37893825.mp3,What Is Life?,10,0,female_feminine,10,1908
3904,1464030,common_voice_en_32858367.mp3,Each team played the other three teams twice.,10,0,female_feminine,10,5616
3905,1464031,common_voice_en_32858393.mp3,Alang earned her first degree in Sociology and Anthropology at the University of Buea.,10,0,female_feminine,10,8028
3906,1464032,common_voice_en_32858394.mp3,Genes get turned on if this mark is acetylated and silences them if methylated.,10,0,female_feminine,10,9756
3907,1464033,common_voice_en_32858395.mp3,Residents of Hibbing lobbied to save the historic building.,10,0,female_feminine,10,6768
3908,1464034,common_voice_en_32858396.mp3,Manya and Volodya fell in love with each other in their school years.,10,0,female_feminine,10,6840
3909,1464035,common_voice_en_32858397.mp3,The typical habitats of the two species also differ strongly.,10,0,female_feminine,10,7128
3910,418628,common_voice_en_59124.mp3,I was disappointed at this inanimate bulk.,10,0,female_feminine,10,3480
3911,1464036,common_voice_en_32858423.mp3,He also had six grandchildren.,10,0,female_feminine,10,4860
3912,1464038,common_voice_en_32858426.mp3,Staff members are trained to spot the lanyards and help the wearer.,10,0,female_feminine,10,6768
3913,1464040,common_voice_en_32858444.mp3,It was also the first time he designed for men.,10,0,female_feminine,10,5220
3914,1464027,common_voice_en_32858363.mp3,Ono himself continues to proclaim his innocence in the serial murders.,10,0,female_feminine,10,6588
3915,1463979,common_voice_en_32857181.mp3,An annual Anzac Day service is held at the war memorial.,10,0,female_feminine,10,7020
3916,1463980,common_voice_en_32857182.mp3,He was an active Freemason and member of the United Baptist church.,10,0,female_feminine,10,6156
3917,1463981,common_voice_en_32857183.mp3,Her debut came after many appearances in national development tours and development squads.,10,0,female_feminine,10,7956
3918,1463982,common_voice_en_32857184.mp3,He arranges for his education.,10,0,female_feminine,10,3996
3919,1463983,common_voice_en_32857216.mp3,She was defeated in both her first ladies singles and ladies doubles with Wallis.,10,0,female_feminine,10,7308
3920,1463986,common_voice_en_32857220.mp3,Just inland from this western point of Sunny Bay lived the Dykes.,10,0,female_feminine,10,5796
3921,1463988,common_voice_en_32857236.mp3,Its story is based on the Battle of Karbala.,10,0,female_feminine,10,5328
3922,1463989,common_voice_en_32857237.mp3,He was succeeded by James Murison.,10,0,female_feminine,10,4356
3923,1463990,common_voice_en_32857238.mp3,Very little is known about this special operations unit.,10,0,female_feminine,10,5688
3924,1463992,common_voice_en_32857240.mp3,Shidib is the nearest rural locality.,10,0,female_feminine,10,5616
3925,1463994,common_voice_en_32857248.mp3,It is located in the east of the city.,10,0,female_feminine,10,5220
3926,1463995,common_voice_en_32857263.mp3,It investigates human relationships with the natural world.,10,0,female_feminine,10,7308
3927,1464012,common_voice_en_32858314.mp3,The novel has been described as musical in tone.,10,0,female_feminine,10,5400
3928,1463997,common_voice_en_32857266.mp3,Kwame Karikari was the former chairman of the organization.,10,0,female_feminine,10,6408
3929,1463998,common_voice_en_32857273.mp3,She forgives him after he promises not to fight again.,10,0,female_feminine,10,5148
3930,1463999,common_voice_en_32857274.mp3,The original route was then filled in.,10,0,female_feminine,10,3960
3931,1464000,common_voice_en_32857275.mp3,He also directed and appeared as an actor films and television.,10,0,female_feminine,10,5616
3932,1464001,common_voice_en_32857276.mp3,The district has coal and mica mines.,10,0,female_feminine,10,4716
3933,1464002,common_voice_en_32857277.mp3,It primarily overlies Jurassic marine sediments or gneiss basement.,10,0,female_feminine,10,7128
3934,1464004,common_voice_en_32857294.mp3,It defended this position during the next offensive (the Battle of Festubert).,10,0,female_feminine,10,6840
3935,1464006,common_voice_en_32857297.mp3,The railway station was destroyed by Prussian artillery.,10,0,female_feminine,10,6300
3936,1463975,common_voice_en_32857166.mp3,The remaining two positions of each pool will be randomly drawn.,10,0,female_feminine,10,6156
3937,1464008,common_voice_en_32858305.mp3,His lyrics address topics such as alienation and mental health.,10,0,female_feminine,10,6840
3938,1464009,common_voice_en_32858306.mp3,Sri Lanka finished at nineteenth position during the World Cup tournament.,10,0,female_feminine,10,7308
3939,1464010,common_voice_en_32858307.mp3,Romanov is the nearest rural locality.,10,0,female_feminine,10,5580
3940,1464011,common_voice_en_32858308.mp3,The most beautiful.,10,0,female_feminine,10,3636
3941,216015,common_voice_en_53442.mp3,The crowd swayed a little as I elbowed my way through.,12,2,female_feminine,10,3264
3942,1464069,common_voice_en_32865294.mp3,Initially many thousands of citizens voluntarily began clearing city by hand.,10,0,female_feminine,10,8928
3943,1464070,common_voice_en_32865301.mp3,The fighting lasted until the beginning of May.,10,0,female_feminine,10,4860
3944,1464039,common_voice_en_32858427.mp3,He played wide receiver and safety in high school.,10,0,female_feminine,10,4716
3945,1464072,common_voice_en_32865310.mp3,Potassium chloride is generated in the process.,10,0,female_feminine,10,5400
3946,1464073,common_voice_en_32865311.mp3,He did not believe existing eclipse photos would be useful.,10,0,female_feminine,10,5616
3947,1464075,common_voice_en_32865314.mp3,He is the son of Awadhi language poet and freedom fighter Banke Lal Asthana.,10,0,female_feminine,10,10368
3948,1464077,common_voice_en_32865316.mp3,He was succeeded in his baronetcy by his eldest son William.,10,0,female_feminine,10,7236
3949,1464078,common_voice_en_32865317.mp3,Minhyuk thinks the song fits between fall and winter.,10,0,female_feminine,10,6840
3950,955982,common_voice_en_31219177.mp3,Alex Segal was the director and David Susskind the producer.,10,0,female_feminine,10,4500
3951,1464081,common_voice_en_32865333.mp3,Rasmussen.,10,0,female_feminine,10,4140
3952,921899,common_voice_en_39143020.mp3,Pointing with index finger may be used to indicate an item or person.,10,0,female_feminine,10,6336
3953,1464083,common_voice_en_32865335.mp3,He and his wife Madeleine Moore Burrell live in Chicago.,10,0,female_feminine,10,7056
3954,418636,common_voice_en_59132.mp3,And he wasn't faring much better.,10,0,female_feminine,10,2616
3955,1464085,common_voice_en_32865342.mp3,Tickets for the event sold out.,10,0,female_feminine,10,4356
3956,1464086,common_voice_en_32865343.mp3,The case was placed before the Presbytery of Ayr and the minister was suspended.,10,0,female_feminine,10,7236
3957,1464055,common_voice_en_32865274.mp3,It was continued by seven stones with the same team.,10,0,female_feminine,10,5796
3958,1464088,common_voice_en_32865345.mp3,The organ is richly decorated.,10,0,female_feminine,10,4428
3959,1464089,common_voice_en_32865347.mp3,Sargent started out teaching kindergarten in New York for Teach for America.,10,0,female_feminine,10,7380
3960,1464091,common_voice_en_32865350.mp3,Nijat Rahimov is the nephew of Yashar Nuri.,10,0,female_feminine,10,6660
3961,1464092,common_voice_en_32865351.mp3,The exterior in quarry stone masonry was intended for plastering.,10,0,female_feminine,10,7056
3962,1464095,common_voice_en_32886749.mp3,This was not an isolated incident.,10,0,female_feminine,10,4968
3963,1464096,common_voice_en_32886750.mp3,they just haven't been implemented yet,10,0,female_feminine,10,4608
3964,1464097,common_voice_en_32886751.mp3,The film was shot at an international school near Kerala.,10,0,female_feminine,10,6840
3965,1663361,common_voice_en_38018098.mp3,It is currently managed by the Scottish Wildlife Trust.,10,0,female_feminine,10,6228
3966,1660074,common_voice_en_37959845.mp3,The album has since been released in South Africa.,10,0,female_feminine,10,5328
3967,1464098,common_voice_en_32886752.mp3,A large hole was torn in the hull which completely flooded the engine room.,10,0,female_feminine,10,7956
3968,1464084,common_voice_en_32865336.mp3,God knows if the present situation has not covered your military responsibility since yesterday.,10,0,female_feminine,10,8316
3969,1464041,common_voice_en_32858445.mp3,A decorated second story choir rises at the rear of the nave.,10,0,female_feminine,10,8100
3970,1464042,common_voice_en_32858446.mp3,The music was composed by Ilaiyaraaja.,10,0,female_feminine,10,4896
3971,1464044,common_voice_en_32858453.mp3,Or would there?,10,0,female_feminine,10,2736
3972,1464045,common_voice_en_32858455.mp3,The education system of Village is very impressive.,10,0,female_feminine,10,4968
3973,1464046,common_voice_en_32865265.mp3,There were two additions built onto the rear of the house.,10,0,female_feminine,10,5616
3974,1464048,common_voice_en_32865267.mp3,Maestre de campo Salvador Cabrito was besieged in the town of Angol.,10,0,female_feminine,10,8568
3975,1464049,common_voice_en_32865268.mp3,The series is hosted by Cornel West and Tricia Rose.,10,0,female_feminine,10,5616
3976,1464050,common_voice_en_32865269.mp3,The round ends if the higher seed exceeds the total of the first hitter.,10,0,female_feminine,10,6156
3977,1464051,common_voice_en_32865270.mp3,Access was from the main driveway and footpaths from the adjacent footbridge.,10,0,female_feminine,10,7956
3978,1464053,common_voice_en_32865272.mp3,He was born shortly after his father began his term as vice president.,10,0,female_feminine,10,6588
3979,1464054,common_voice_en_32865273.mp3,More than ten unnamed fishing ships from mainland China were in Kinmen County waters.,10,0,female_feminine,10,8460
3980,1464023,common_voice_en_32858344.mp3,It has been tested against brick walls and reinforced concrete.,10,0,female_feminine,10,6588
3981,1464068,common_voice_en_32865293.mp3,He was married and had two sons and two daughters.,10,0,female_feminine,10,5220
3982,1464057,common_voice_en_32865276.mp3,King James asked for confirmation that such an old debt was still outstanding.,10,0,female_feminine,10,8208
3983,1464058,common_voice_en_32865277.mp3,The bands were excommunicated.,10,0,female_feminine,10,3780
3984,1464059,common_voice_en_32865278.mp3,The pulpit and the baptismal font are both designed by the architect.,10,0,female_feminine,10,6156
3985,1464060,common_voice_en_32865279.mp3,This journey framed his first book.,10,0,female_feminine,10,3960
3986,1464061,common_voice_en_32865285.mp3,International applicants are eligible to apply for enrollment.,10,0,female_feminine,10,6516
3987,1464062,common_voice_en_32865286.mp3,Some rioters also broke into the Providence Place Mall and stole items.,10,0,female_feminine,10,6840
3988,1067135,common_voice_en_34948165.mp3,Some winners have become immensely popular and commercially successful.,10,0,female_feminine,10,5508
3989,1464063,common_voice_en_32865287.mp3,He was suspended from his position as Registrar of Deeds.,10,0,female_feminine,10,6876
3990,1464064,common_voice_en_32865288.mp3,The stems are made up of segments up to long and in diameter.,10,0,female_feminine,10,7740
3991,1464065,common_voice_en_32865289.mp3,The lake is part of the Lake Nipigon Conservation Reserve.,10,0,female_feminine,10,5436
3992,1464066,common_voice_en_32865290.mp3,He wrote the song about his son Albert.,10,0,female_feminine,10,4968
3993,1464067,common_voice_en_32865292.mp3,This decision was met with surprise and criticism from some circles.,10,0,female_feminine,10,7056
3994,955997,common_voice_en_31219197.mp3,They had at least four sons and one daughter.,10,0,female_feminine,10,3528
3995,1671984,common_voice_en_20286043.mp3,It has a program that will ensure a gymnasium diploma in standard courses.,10,0,female_feminine,10,6408
3996,430791,common_voice_en_30488868.mp3,He went to Nicholls State University.,10,0,female_feminine,10,3996
3997,430790,common_voice_en_30488867.mp3,I especially had fun with this one.,10,0,female_feminine,10,3420
3998,430789,common_voice_en_30488866.mp3,The Racers were picked to finish in seventh place.,10,0,female_feminine,10,4140
3999,430787,common_voice_en_30488864.mp3,Together they have one son and two daughters.,10,0,female_feminine,10,4284
4000,438103,common_voice_en_56995.mp3,The greatest authority on meteorites stated that the height of its first appearance was about ninety or one hundred miles.,11,1,female_feminine,10,9384
4001,944618,common_voice_en_33393625.mp3,They were assigned to their first Junior Grand Prix events.,10,0,female_feminine,10,4248
4002,430801,common_voice_en_30488881.mp3,It is located inside Dungiven Castle.,10,0,female_feminine,10,4788
4003,944619,common_voice_en_33393626.mp3,She was also an outstanding student in the classroom.,10,0,female_feminine,10,4320
4004,1063234,common_voice_en_37010906.mp3,They did not have a permanent drummer at the time.,10,0,female_feminine,10,4140
4005,944620,common_voice_en_33393627.mp3,He fought in the Bangladesh Liberation war.,10,0,female_feminine,10,3888
4006,944621,common_voice_en_33393628.mp3,He was educated at Aylesbury Grammar School.,10,0,female_feminine,10,3780
4007,1463915,common_voice_en_32644557.mp3,"This name translates to the little ""river where the current is"".",10,0,female_feminine,10,7740
4008,1463978,common_voice_en_32857180.mp3,"I’m really looking forward to teaching them, especially teaching partial numbers",10,0,female_feminine,10,8316
4009,630684,common_voice_en_48158.mp3,They were relieved and happy.,10,0,female_feminine,10,2520
4010,944624,common_voice_en_33393657.mp3,The listing includes Resch Park.,10,0,female_feminine,10,3420
4011,438115,common_voice_en_57007.mp3,Hundreds of observers saw the flame that night and the night after.,11,1,female_feminine,10,5472
4012,220030,common_voice_en_20285956.mp3,It says: 'In my mind there's no sorrow...' It's all in your mind.,10,0,female_feminine,10,6840
4013,944627,common_voice_en_33393685.mp3,After the army he continued his studies at the seminary.,10,0,female_feminine,10,4140
4014,944629,common_voice_en_33393687.mp3,"Presley Gerber Mike Wass of ""Idolator"" called the video ""sexy and emotional"".",10,0,female_feminine,10,6480
4015,1463917,common_voice_en_32644639.mp3,Carl Edvard van Dockum was the son of Vice Admiral and his wife.,10,0,female_feminine,10,8460
4016,1463918,common_voice_en_32644641.mp3,Both individuals detained this evening are black.,10,0,female_feminine,10,5760
4017,1463920,common_voice_en_32644698.mp3,He married and had two daughters.,10,0,female_feminine,10,4140
4018,1463921,common_voice_en_32644703.mp3,He advanced to the next round with the highest percentage result.,10,0,female_feminine,10,6588
4019,1463922,common_voice_en_32644705.mp3,The Khanda river cuts across the range further south.,10,0,female_feminine,10,5220
4020,1463925,common_voice_en_32644765.mp3,There is no further historical record of Tiberius.,10,0,female_feminine,10,6300
4021,1189315,common_voice_en_33384408.mp3,This literary bookstore was popular with visitors to the city.,12,2,female_feminine,10,5256
4022,944622,common_voice_en_33393629.mp3,The regiment is based in Anzio in Lazio.,10,0,female_feminine,10,4500
4023,227613,common_voice_en_101253.mp3,"In those days, very few of the people had any idea about astronomy.",10,0,female_feminine,10,5304
4024,944600,common_voice_en_32836931.mp3,He was the youngest of the eight children.,10,0,female_feminine,10,2880
4025,944601,common_voice_en_32836932.mp3,Canton minor league teams were noted to have played at Athletic Park.,10,0,female_feminine,10,5940
4026,1147308,common_voice_en_37570056.mp3,It is this chance aspect of bending that serves as the foundation of circuit-bending.,10,0,female_feminine,10,5832
4027,944603,common_voice_en_32836945.mp3,The music was taken from Franz Schubert.,10,0,female_feminine,10,3708
4028,944605,common_voice_en_32836947.mp3,This goodenia grows in seasonally wet soil in the north of the Northern Territory.,10,0,female_feminine,10,6660
4029,944608,common_voice_en_32836980.mp3,In the seventeenth century additions were made to the manor.,10,0,female_feminine,10,4896
4030,944609,common_voice_en_32836981.mp3,La Sepultura Biosphere Reserve covers the western end of the Sierra Madre de Chiapas.,10,0,female_feminine,10,7236
4031,944610,common_voice_en_32836982.mp3,He later moved to the United States to pursue his career in acting.,10,0,female_feminine,10,4896
4032,944611,common_voice_en_32836983.mp3,Her work is in the Stedelijk Museum Amsterdam.,10,0,female_feminine,10,4428
4033,944612,common_voice_en_32836984.mp3,Andrei won five national championships at individual senior level.,10,0,female_feminine,10,6300
4034,944613,common_voice_en_32837015.mp3,She devoted tine to creating biographies for woman in history.,10,0,female_feminine,10,4896
4035,430792,common_voice_en_30488869.mp3,It was included along with other songs of the genre Neues Geistliches Lied.,10,0,female_feminine,10,7164
4036,944617,common_voice_en_32837019.mp3,Adverse effects include constipation and sedation.,10,0,female_feminine,10,4716
4037,430810,common_voice_en_30488943.mp3,"As well as they have to pass an ""elimination"" round.",10,0,female_feminine,10,4716
4038,430809,common_voice_en_30488942.mp3,"So impressive were the portals that they became known as the ""Gates of Jerusalem"".",10,0,female_feminine,10,6156
4039,430807,common_voice_en_30488940.mp3,It is the only known site in Utah associated with Harris.,10,0,female_feminine,10,5580
4040,430805,common_voice_en_30488933.mp3,This is the entire basis of their relationship.,10,0,female_feminine,10,4320
4041,430804,common_voice_en_30488932.mp3,The lyrics of the song was written by Gulzar.,10,0,female_feminine,10,4536
4042,430803,common_voice_en_30488883.mp3,He was the President of the Kalutara Bar Association.,10,0,female_feminine,10,5256
4043,430800,common_voice_en_30488880.mp3,It does not form hydrates.,10,0,female_feminine,10,3132
4044,430799,common_voice_en_30488879.mp3,With Saturn is the planet with the largest equatorial bulge in our Solar System.,10,0,female_feminine,10,8856
4045,430797,common_voice_en_30488876.mp3,"He illustrated poems by Tennyson for ""Vanity Fair"".",10,0,female_feminine,10,5076
4046,430796,common_voice_en_30488874.mp3,Significant crops include rice and corn.,10,0,female_feminine,10,4500
4047,430794,common_voice_en_30488872.mp3,She had the most intercepts of any player in the season.,10,0,female_feminine,10,4356
4048,430793,common_voice_en_30488871.mp3,And has hosted the Ekpe festival on several occasions.,10,0,female_feminine,10,5508
4049,1463914,common_voice_en_32644556.mp3,Berlin was the first editor.,10,0,female_feminine,10,5220
4050,944643,common_voice_en_33393787.mp3,Candidate of Sciences.,10,0,female_feminine,10,3456
4051,944644,common_voice_en_33393789.mp3,"He had appeared in ""A Sleep of Prisoners"".",10,0,female_feminine,10,3960
4052,1463952,common_voice_en_32814464.mp3,It is also known as the Paraguay dwarf sucker.,10,0,female_feminine,10,4608
4053,1463953,common_voice_en_32814465.mp3,He became Veterinary Advisor to the City of Edinburgh.,10,0,female_feminine,10,5148
4054,1463954,common_voice_en_32814487.mp3,His political allegiance was given to the Democratic party.,10,0,female_feminine,10,5220
4055,1463955,common_voice_en_32814488.mp3,Queensland did not have any experts in algae at the time.,10,0,female_feminine,10,5040
4056,1463956,common_voice_en_32814489.mp3,She currently lives in Bilbao.,10,0,female_feminine,10,5580
4057,1463957,common_voice_en_32814490.mp3,He flew only two more missions after recovering before the war ended.,10,0,female_feminine,10,8856
4058,1463958,common_voice_en_32814491.mp3,The sepals are hairy and long with hairy bracteoles long at the base.,10,0,female_feminine,10,9180
4059,1463927,common_voice_en_32644767.mp3,Nurse scientists have been regarded as knowledge brokers.,10,0,female_feminine,10,7128
4060,1463960,common_voice_en_32814494.mp3,There is gold ore prospection in the area of the range.,10,0,female_feminine,10,5616
4061,1463962,common_voice_en_32826832.mp3,Right corner Jewish family viewers are waiting for the outcome.,10,0,female_feminine,10,5940
4062,1463926,common_voice_en_32644766.mp3,Tweet has taken some major stylistic leaps in this book.,10,0,female_feminine,10,6840
4063,1463965,common_voice_en_32826872.mp3,It is the most famous local product of the prefecture of Florina.,10,0,female_feminine,10,5868
4064,1463966,common_voice_en_32826874.mp3,Wang returned to Jicheng soon after.,10,0,female_feminine,10,4608
4065,1463967,common_voice_en_32826875.mp3,Marsh Fork Elementary was threatened on two fronts.,10,0,female_feminine,10,4788
4066,1463968,common_voice_en_32826876.mp3,Was he mortally afraid of violent death?,10,0,female_feminine,10,4356
4067,1463969,common_voice_en_32857160.mp3,Bundesliga club Dynamo Dresden.,10,0,female_feminine,10,7020
4068,1463970,common_voice_en_32857161.mp3,The video was directed by Simon Cahn.,10,0,female_feminine,10,5616
4069,1463971,common_voice_en_32857162.mp3,He scored in every race and scored four third places for best results.,10,0,female_feminine,10,7776
4070,1463972,common_voice_en_32857163.mp3,She was the middle child of three.,10,0,female_feminine,10,4500
4071,1463973,common_voice_en_32857164.mp3,It is headquartered in Carson City and maintains an additional office in Las Vegas.,10,0,female_feminine,10,7740
4072,1463974,common_voice_en_32857165.mp3,Keramat Ali Tang.,10,0,female_feminine,10,4716
4073,1463943,common_voice_en_32814441.mp3,Was implicit bias involved?,10,0,female_feminine,10,4536
4074,1463976,common_voice_en_32857167.mp3,She attended University of Toronto and graduated with an Honours Bachelor of Arts.,10,0,female_feminine,10,8100
4075,1463977,common_voice_en_32857169.mp3,Poliana is forced to obey numerous rules and set times.,10,0,female_feminine,10,6120
4076,1463964,common_voice_en_32826834.mp3,Erickson was then subdued and disarmed by two other students.,10,0,female_feminine,10,6588
4077,1463895,common_voice_en_32644189.mp3,She also served as the president of the Los Angeles Church Women United chapter.,10,0,female_feminine,10,10008
4078,1463929,common_voice_en_32814332.mp3,It was first published by Subterranean Press.,10,0,female_feminine,10,6588
4079,240548,common_voice_en_10096.mp3,You point to a trail of ants leading into the house.,13,3,female_feminine,10,4344
4080,1463930,common_voice_en_32814333.mp3,They were not eligible to play in the post season.,10,0,female_feminine,10,5940
4081,1463931,common_voice_en_32814334.mp3,"The sea conditions were ""unpromising but not prohibitive"".",10,0,female_feminine,10,5688
4082,1463932,common_voice_en_32814335.mp3,He used unusual metres.,10,0,female_feminine,10,3996
4083,1382629,common_voice_en_38355028.mp3,Balla has only one street.,12,2,female_feminine,10,3168
4084,1463933,common_voice_en_32814336.mp3,It is constructed in coursed limestone.,10,0,female_feminine,10,4896
4085,1463936,common_voice_en_32814371.mp3,"The shelling injured two French journalists from ""Le Monde"" newspaper and two Armenian journalists.",10,0,female_feminine,10,9576
4086,1463937,common_voice_en_32814372.mp3,Later that year she represented Australia at the Junior World Championships.,10,0,female_feminine,10,7848
4087,1463938,common_voice_en_32814430.mp3,The company was created in part with funding from Kickstarter.,10,0,female_feminine,10,5796
4088,1463940,common_voice_en_32814432.mp3,The Canary Islands is an Autonomous community of Spain.,10,0,female_feminine,10,5580
4089,944642,common_voice_en_33393786.mp3,But I want you to know that we are going to be okay.,10,0,female_feminine,10,4248
4090,1463911,common_voice_en_32644522.mp3,All: I confess to almighty God,10,0,female_feminine,10,5688
4091,944636,common_voice_en_33393750.mp3,No new information or evidence is presented.,10,0,female_feminine,10,4248
4092,1463944,common_voice_en_32814443.mp3,Carrie Farnsworth spoke and understood Turkish fluently.,10,0,female_feminine,10,5580
4093,1463945,common_voice_en_32814444.mp3,A number of his orchestral works were heard in Bournemouth under Dan Godfrey.,10,0,female_feminine,10,7920
4094,1463946,common_voice_en_32814445.mp3,The middle and lower watershed is underlaid by Raleigh Gneiss geology.,10,0,female_feminine,10,6840
4095,1463947,common_voice_en_32814456.mp3,Her research considers the application of two dimensional materials in disease detection and diagnosis.,10,0,female_feminine,10,10008
4096,1463948,common_voice_en_32814458.mp3,Elle Kari is very sad.,10,0,female_feminine,10,3996
4097,1463949,common_voice_en_32814459.mp3,Tamannaah appeared in the lead role.,10,0,female_feminine,10,4248
4098,1463950,common_voice_en_32814461.mp3,Flora returned to Port Moresby with her son and daughter.,10,0,female_feminine,10,4716
4099,944639,common_voice_en_33393753.mp3,The concept is fundamental to many theories of discourse.,10,0,female_feminine,10,4716
4100,944640,common_voice_en_33393754.mp3,She has more than one hundred scientific publications.,10,0,female_feminine,10,4176
4101,1463951,common_voice_en_32814463.mp3,I still don’t quite see it.,10,0,female_feminine,10,3348
4102,944641,common_voice_en_33393785.mp3,"On ""Ruins"" Frith used Fibonacci numbers to establish beat and harmony.",10,0,female_feminine,10,6156
4103,1463942,common_voice_en_32814434.mp3,She was elected thrice as Berhampore Vidhan Sabha Constituency in West Bengal Legislative Assembly.,10,0,female_feminine,10,9828
4104,1464718,common_voice_en_35120925.mp3,Training opportunities occur every February and March.,10,0,female_feminine,10,5796
4105,1464719,common_voice_en_35120926.mp3,"Warmages take the concept of ""magical artillery"" to its extreme.",10,0,female_feminine,10,7128
4106,1464720,common_voice_en_35120927.mp3,"Men also wore these ""Frisian blouses"" on occasion.",10,0,female_feminine,10,6048
4107,1464721,common_voice_en_35120928.mp3,The total wall thickness of the mosque reaches one meter.,10,0,female_feminine,10,6480
4108,1464722,common_voice_en_35126053.mp3,He proved to be an inspirational speaker and talented recruiter.,10,0,female_feminine,10,5400
4109,1464725,common_voice_en_35160744.mp3,These modified De Havilland aircraft were intended for domestic airlines established in Romania.,10,0,female_feminine,10,8244
4110,1464690,common_voice_en_35024049.mp3,It belongs to the nyaya panchayat of Hajipur.,10,0,female_feminine,10,5760
4111,1464729,common_voice_en_35160748.mp3,This oil is used to produce steam in stationary boilers.,10,0,female_feminine,10,6912
4112,1464563,common_voice_en_33382533.mp3,Amemiya is the son of former Hawaii Attorney General Ronald Amemiya.,10,0,female_feminine,10,9288
4113,1464732,common_voice_en_35193024.mp3,Both Archbishop Thomas and Bishop John strongly protested against the agreement.,10,0,female_feminine,10,6984
4114,1464734,common_voice_en_35193026.mp3,"Ellen Dunne was well-read, and created a bookish environment for her children.",10,0,female_feminine,10,6336
4115,1464735,common_voice_en_35193027.mp3,The drinking cups stand out as the most famous part of the set.,10,0,female_feminine,10,6264
4116,1464736,common_voice_en_35193029.mp3,"The track listing is unknown, but the idea was scrapped for single album releases.",10,0,female_feminine,10,8244
4117,1464737,common_voice_en_35193030.mp3,"Doc, by contrast, is successful, buying a funeral home.",10,0,female_feminine,10,5976
4118,1464738,common_voice_en_35193032.mp3,Males emerge to call beside temporary rainwater streams.,10,0,female_feminine,10,6156
4119,1464740,common_voice_en_35193034.mp3,"As First Deputy Premier, Tikhonov was able to reduce Kosygin to a standby figure.",10,0,female_feminine,10,8100
4120,1464741,common_voice_en_35193035.mp3,"He relocated to Sedalia, Missouri.",10,0,female_feminine,10,3960
4121,682962,common_voice_en_44635.mp3,I wished I had a light to smoke by.,10,0,female_feminine,10,3504
4122,1464730,common_voice_en_35160749.mp3,A heater was an optional extra.,10,0,female_feminine,10,2988
4123,1464687,common_voice_en_35024045.mp3,This has led to a movement to slow down the zapper.,10,0,female_feminine,10,5616
4124,1464688,common_voice_en_35024046.mp3,Cresserons is located just south of the beaches of Normandy.,10,0,female_feminine,10,5148
4125,1464689,common_voice_en_35024047.mp3,Posts are moderated.,10,0,female_feminine,10,3816
4126,1464654,common_voice_en_34061259.mp3,An extended clip was released during an interview with showrunner Al Jean.,10,0,female_feminine,10,6732
4127,1464691,common_voice_en_35024088.mp3,Most of the gameplay is similar to the previous game in the series.,10,0,female_feminine,10,6660
4128,1464693,common_voice_en_35024090.mp3,Two runways of Sydney Airport extend into the bay.,10,0,female_feminine,10,5760
4129,1464694,common_voice_en_35024091.mp3,"For example, greetings such as ""hello"" and ""how are you?",10,0,female_feminine,10,6768
4130,1464695,common_voice_en_35024141.mp3,"The term is often shortened to ""lex loci delicti"".",10,0,female_feminine,10,6588
4131,1464717,common_voice_en_35118544.mp3,"For details on the court system, see Canadian court system.",10,0,female_feminine,10,5976
4132,1464699,common_voice_en_35024164.mp3,"Supporting Japanese, Berry includes Whiz, a sharp Kana-Kanji conversion system.",10,0,female_feminine,10,8748
4133,1464700,common_voice_en_35024165.mp3,"In cryptography, a codebook is a document used for implementing a code.",10,0,female_feminine,10,7236
4134,1464701,common_voice_en_35024166.mp3,It was also the precursor of the modern tailored kilt.,10,0,female_feminine,10,6228
4135,1464706,common_voice_en_35047594.mp3,John Wesley originally called this experience the New Birth.,10,0,female_feminine,10,6300
4136,1464707,common_voice_en_35047596.mp3,The Count directs his demon minions to deal with those sneaking around backstage.,10,0,female_feminine,10,8388
4137,1464708,common_voice_en_35047598.mp3,Cricket offers a variety of rate plans that include data allowance.,10,0,female_feminine,10,5868
4138,1464709,common_voice_en_35118510.mp3,"Otherwise, they wouldn't be suspects, would they?",10,0,female_feminine,10,6660
4139,1464674,common_voice_en_34392536.mp3,During this time he also lectured at Novosibirsk State University.,10,0,female_feminine,10,7200
4140,1464711,common_voice_en_35118512.mp3,They decide to conceal the fact that her boyfriend dumped her.,10,0,female_feminine,10,5256
4141,1464698,common_voice_en_35024162.mp3,His wife and daughter returned to Germany and Lena visited him in prison.,10,0,female_feminine,10,7596
4142,1464773,common_voice_en_35287461.mp3,It has been invaluable for scholars of his time and since.,10,0,female_feminine,10,6228
4143,1464776,common_voice_en_35287465.mp3,"There his father, an American Revolutionary War veteran, worked as a farmer.",10,0,female_feminine,10,6408
4144,1464777,common_voice_en_35287468.mp3,"She did a number of landscapes, with a particular attachment for Quebec's Eastern Townships.",10,0,female_feminine,10,7560
4145,1464778,common_voice_en_35287469.mp3,The results obtained revealed an original biosynthetic pathway leading to sterols in photosynthetic eukaryotes.,10,0,female_feminine,10,9756
4146,1464780,common_voice_en_35292786.mp3,"After moving to Sale, he suspended his studies at the University.",10,0,female_feminine,10,8100
4147,1464790,common_voice_en_35347122.mp3,Her poems received extensive publication in the periodical press.,10,0,female_feminine,10,5436
4148,1464792,common_voice_en_35347167.mp3,The woman then says she has to go to work and leaves the frame.,10,0,female_feminine,10,5580
4149,1464795,common_voice_en_35347170.mp3,"The route has two special routes, all business routes in Texas.",10,0,female_feminine,10,6048
4150,1464743,common_voice_en_35202285.mp3,Celeste was named for the wife of a Santa Fe official.,10,0,female_feminine,10,6228
4151,1464798,common_voice_en_36312950.mp3,Today the room is the farm's library.,10,0,female_feminine,10,5616
4152,1464799,common_voice_en_36312951.mp3,"Among these were soap, sugar, barley, oranges, and cotton.",10,0,female_feminine,10,7668
4153,1464802,common_voice_en_36321289.mp3,"Curtis was born in Columbus, Ohio and grew up in Ostrander.",10,0,female_feminine,10,6480
4154,1464803,common_voice_en_36321290.mp3,She also played with the Royal Philharmonic Orchestra under Sir John Barbirolli.,10,0,female_feminine,10,7380
4155,1464804,common_voice_en_36392619.mp3,Williams is the grandson of former major league outfielder Bert Griffith.,10,0,female_feminine,10,7236
4156,1464805,common_voice_en_36392620.mp3,"Following her retirement, she has skated professionally in ice shows.",10,0,female_feminine,10,6120
4157,1464806,common_voice_en_36392621.mp3,Much of the film is Westernized for a Western audience.,10,0,female_feminine,10,5256
4158,1464807,common_voice_en_36392622.mp3,Another marriage was to Arthur Chesney.,10,0,female_feminine,10,4248
4159,1464808,common_voice_en_36392623.mp3,Jeeva and Vicky would then share the bounty.,10,0,female_feminine,10,4896
4160,1464796,common_voice_en_35347171.mp3,"It contains new tracks ""Here With Me"" and ""I Don't Want to Lose You.",10,0,female_feminine,10,6048
4161,1464744,common_voice_en_35202286.mp3,"In spring, temperatures gradually warm up as the days become longer.",10,0,female_feminine,10,6480
4162,1464745,common_voice_en_35202287.mp3,She is also on the board of directors for Boston Properties.,10,0,female_feminine,10,5364
4163,1464747,common_voice_en_35202294.mp3,The district stretches south through the central plateau to the summit of Mauna Loa.,10,0,female_feminine,10,6084
4164,1464748,common_voice_en_35202300.mp3,Music and religious traditions in Iberian culture and Amerindian sounds and flavors.,10,0,female_feminine,10,9576
4165,1464751,common_voice_en_35202335.mp3,Amniocentesis retrieves amniotic fluid by inserting a needle through the pregnant mother's abdominal wall.,10,0,female_feminine,10,8136
4166,1464752,common_voice_en_35202336.mp3,Octave Mirbeau denounces domestic service as a modern form of slavery.,10,0,female_feminine,10,8424
4167,1464753,common_voice_en_35202337.mp3,"The English word ""hock"", a generic term for Rhine wine, is derived from Hochheim.",10,0,female_feminine,10,8460
4168,1464754,common_voice_en_35202338.mp3,Boilers in some power stations use processed natural gas as their main fuel.,10,0,female_feminine,10,7596
4169,1464755,common_voice_en_35202344.mp3,"Robert FitzWalter, the castle's constable, was sent to lead a relief expedition.",10,0,female_feminine,10,7668
4170,1464772,common_voice_en_35287460.mp3,He played college basketball at Arizona State.,10,0,female_feminine,10,4536
4171,1464726,common_voice_en_35160745.mp3,The function of the Yule goat has differed throughout the ages.,10,0,female_feminine,10,5976
4172,1464759,common_voice_en_35282686.mp3,The village church was built on the site of the first castle.,10,0,female_feminine,10,6948
4173,1464762,common_voice_en_35282689.mp3,You only have to check out the chord changes.,10,0,female_feminine,10,5688
4174,1464763,common_voice_en_35282690.mp3,The specific protein glomalin has not yet been isolated and described.,10,0,female_feminine,10,7560
4175,1464765,common_voice_en_35282692.mp3,"Earl Jellicoe was succeeded by his only son, George Patrick John Rushworth Jellicoe.",10,0,female_feminine,10,8568
4176,1464768,common_voice_en_35282695.mp3,The inner bark can also be used to treat burns and cuts.,10,0,female_feminine,10,5400
4177,1464769,common_voice_en_35282696.mp3,It is also possible that not all the underkings were deposed.,10,0,female_feminine,10,4968
4178,1464770,common_voice_en_35282697.mp3,Kapono currently studies coral health at the University of Hawaii at Hilo.,10,0,female_feminine,10,6660
4179,1464771,common_voice_en_35282699.mp3,It is one of the major Hindu Temple complex of Gujarat.,10,0,female_feminine,10,7488
4180,1464757,common_voice_en_35202351.mp3,"Tara Brady of ""The Irish Times"" awarded the film two stars out of five.",10,0,female_feminine,10,5976
4181,1464601,common_voice_en_33732523.mp3,John remarried in the following year.,10,0,female_feminine,10,5292
4182,1464602,common_voice_en_33732539.mp3,Precipitation runoff from the mountain drains to Yellowstone Lake six miles to the west.,10,0,female_feminine,10,7380
4183,1464603,common_voice_en_33732554.mp3,Their traditional local defence duties were taken over by the Volunteers.,10,0,female_feminine,10,6228
4184,1464604,common_voice_en_33732571.mp3,Yoga groups soon sprang up all over Britain.,10,0,female_feminine,10,4824
4185,1464567,common_voice_en_33382598.mp3,He graduated from Mount Saint Michael Academy in the Bronx.,10,0,female_feminine,10,5436
4186,1464607,common_voice_en_33732622.mp3,No one ever had warmer friends.,10,0,female_feminine,10,4032
4187,1464608,common_voice_en_33732647.mp3,The mutation gives the navel orange no seeds.,10,0,female_feminine,10,4536
4188,1464609,common_voice_en_33732653.mp3,Walter stayed with the team for another two seasons.,10,0,female_feminine,10,4068
4189,1464686,common_voice_en_35024022.mp3,"Co-Executive Producers were John Musilli, Stephen Chodorov; and JoAnn Young, Producer.",10,0,female_feminine,10,10368
4190,1464612,common_voice_en_33732685.mp3,It occurs in the Atlantic Ocean.,10,0,female_feminine,10,3528
4191,1464613,common_voice_en_33732691.mp3,Fate of the other inhabitants of the village is unknown.,10,0,female_feminine,10,5328
4192,1464614,common_voice_en_33732705.mp3,This is the latest installment of the San Beda–Letran rivalry.,10,0,female_feminine,10,5976
4193,1464615,common_voice_en_33732709.mp3,"She described President of France Emmanuel Macron as ""arrogant"".",10,0,female_feminine,10,6264
4194,1464617,common_voice_en_33733065.mp3,Paseo de San Carlos is located in central Downtown San Jose.,10,0,female_feminine,10,6120
4195,1464619,common_voice_en_33844889.mp3,That fall he began attending Michigan in the final recruiting class for Dan Farrell.,10,0,female_feminine,10,8496
4196,1464586,common_voice_en_33440052.mp3,In this first season he played in only one game.,10,0,female_feminine,10,4788
4197,1464624,common_voice_en_33844917.mp3,I was disappointed in Governor Rockefeller.,10,0,female_feminine,10,4788
4198,1464625,common_voice_en_33844918.mp3,"His poems have been described as ""very intimate and confessional"".",10,0,female_feminine,10,5724
4199,1464610,common_voice_en_33732672.mp3,She becomes further frustrated because Bella Yaga never teaches her magic.,10,0,female_feminine,10,6264
4200,1464535,common_voice_en_33319223.mp3,The construction of the mosque was started by the local Muslim community.,10,0,female_feminine,10,5148
4201,1464568,common_voice_en_33382599.mp3,The Catholic Church opposed Nangle and the Achill Mission Colony from the start.,10,0,female_feminine,10,6156
4202,1464570,common_voice_en_33382674.mp3,"Techradar noted that the model is ""on the chunky size"".",10,0,female_feminine,10,6696
4203,1464571,common_voice_en_33382675.mp3,Other fools or jesters at the Scottish court included French Nicola.,10,0,female_feminine,10,6696
4204,1464572,common_voice_en_33382676.mp3,Most stadiums also have standing areas.,10,0,female_feminine,10,4536
4205,1464575,common_voice_en_33382741.mp3,The institute is recognized by Gujarat University.,10,0,female_feminine,10,6048
4206,1464577,common_voice_en_33382745.mp3,The following file formats are supported for direct upload to the site.,10,0,female_feminine,10,7128
4207,1464581,common_voice_en_33440034.mp3,Carranza refused to apologize for the remarks.,10,0,female_feminine,10,5400
4208,1464600,common_voice_en_33732504.mp3,He plays for Belgian club Kortrijk.,10,0,female_feminine,10,4752
4209,1464583,common_voice_en_33440036.mp3,The company proved to be very successful.,10,0,female_feminine,10,4716
4210,1464584,common_voice_en_33440048.mp3,She specializes in lung cancer and brain tumors.,10,0,female_feminine,10,4896
4211,1464585,common_voice_en_33440051.mp3,She was nominated for Best Supporting Actor in the Zulu African Film Academy Awards.,10,0,female_feminine,10,7776
4212,1464551,common_voice_en_33322091.mp3,Lemu also founded the Dawah Coordination Council Of Nigeria and was the first President.,10,0,female_feminine,10,8136
4213,1464593,common_voice_en_33579738.mp3,The three larger provinces are composed of smaller ecoregions.,10,0,female_feminine,10,7776
4214,1464594,common_voice_en_33579741.mp3,Some of the west of the locality is used for grazing.,10,0,female_feminine,10,5616
4215,1464596,common_voice_en_33732323.mp3,She was elected Fellow of the American Association for the Advancement of Science.,10,0,female_feminine,10,7164
4216,1464597,common_voice_en_33732333.mp3,His sentence was then further reduced.,10,0,female_feminine,10,4464
4217,1464599,common_voice_en_33732488.mp3,Five teams joined the tournament.,10,0,female_feminine,10,4464
4218,1464582,common_voice_en_33440035.mp3,He was endorsed by the Democratic Socialists of America.,10,0,female_feminine,10,5220
4219,908682,common_voice_en_31990345.mp3,He was waived three days later after failing his physical.,10,0,female_feminine,10,4860
4220,1464658,common_voice_en_34061318.mp3,It was headed by Robert Hartzell and Mike Shapiro.,10,0,female_feminine,10,5508
4221,1464659,common_voice_en_34061364.mp3,She needs an assistant to analyze the market.,10,0,female_feminine,10,4572
4222,1464664,common_voice_en_34082332.mp3,His running mate was Chinedu Emeka.,10,0,female_feminine,10,6300
4223,1464667,common_voice_en_34082336.mp3,He is best known for writing about Tokyo.,10,0,female_feminine,10,4860
4224,1464668,common_voice_en_34392469.mp3,It has Ramsha Khan and Affan Waheed in lead roles.,10,0,female_feminine,10,6480
4225,1464670,common_voice_en_34392472.mp3,It is elite unit of the Algerian gendarmerie.,10,0,female_feminine,10,8028
4226,1464671,common_voice_en_34392473.mp3,A number of members of Congress criticized the bill as being unfriendly to workers.,10,0,female_feminine,10,8208
4227,1464627,common_voice_en_33844946.mp3,Hall was the Field Director of Terri Lynn Land for Michigan Secretary of State.,10,0,female_feminine,10,9612
4228,1464673,common_voice_en_34392535.mp3,In both events he was the only competitor.,10,0,female_feminine,10,4428
4229,1464676,common_voice_en_34392538.mp3,She also occasionally used fire to burn parts of the canvases.,10,0,female_feminine,10,5508
4230,1464677,common_voice_en_34392627.mp3,While one contestant of the losing team will be eliminated.,10,0,female_feminine,10,5580
4231,1464678,common_voice_en_34392628.mp3,The Danube Delta is the best known of the wetlands.,10,0,female_feminine,10,4788
4232,1662550,common_voice_en_38005024.mp3,Only you can do that.,12,2,female_feminine,10,2988
4233,1464680,common_voice_en_34392630.mp3,The point system consists of outcome based scoring and bonuses for an early win.,10,0,female_feminine,10,6696
4234,1464681,common_voice_en_34956490.mp3,"The ceremony is marked with dancing, feasting, fasting and religious observations.",10,0,female_feminine,10,7920
4235,1464682,common_voice_en_34956491.mp3,Lots of fun.,10,0,female_feminine,10,2808
4236,1464684,common_voice_en_35024017.mp3,There are many local landraces.,10,0,female_feminine,10,5040
4237,1464672,common_voice_en_34392534.mp3,It is most common in areas that have been little affected by grazing.,10,0,female_feminine,10,5868
4238,1464628,common_voice_en_33844958.mp3,Preparations were held by the Jakarta province and the North Jakarta City.,10,0,female_feminine,10,7092
4239,1464634,common_voice_en_33845127.mp3,The election was won by Adolphus Wabara of the Peoples Democratic Party.,10,0,female_feminine,10,6804
4240,1464637,common_voice_en_33845184.mp3,It is also the first album to be produced entirely by the band.,10,0,female_feminine,10,7884
4241,1489335,common_voice_en_38743633.mp3,The deviations will be most noticeable under conditions of low concentration and high absorbance.,10,0,female_feminine,10,8280
4242,1464606,common_voice_en_33732613.mp3,"The average status was assessed as ""very moderate and frugal cast"".",10,0,female_feminine,10,5904
4243,1464639,common_voice_en_33963081.mp3,She later confronts Sakaki and finally cut ties with him.,10,0,female_feminine,10,5508
4244,1464641,common_voice_en_33967570.mp3,Other candidates for the position reportedly included Lane Kiffin and Mike Leach.,10,0,female_feminine,10,7740
4245,1464642,common_voice_en_33967571.mp3,"Credits for ""Pausa"" adapted from Tidal.",10,0,female_feminine,10,4896
4246,1464644,common_voice_en_33967573.mp3,It was previously home to the Quebec Arena.,10,0,female_feminine,10,6696
4247,1464657,common_voice_en_34061312.mp3,He served in the signal corps during the Great Patriotic War.,10,0,female_feminine,10,6408
4248,1464646,common_voice_en_33967658.mp3,She has won several awards at the local stage drama festivals and television festivals.,10,0,female_feminine,10,9036
4249,1464647,common_voice_en_33967659.mp3,What Leprous has achieved is an exercise in mastery.,10,0,female_feminine,10,5688
4250,1464648,common_voice_en_33967660.mp3,He was buried in the Babaoshan Revolutionary Cemetery.,10,0,female_feminine,10,5580
4251,1464649,common_voice_en_33984505.mp3,The foundations of several pit dwellings were also found.,10,0,female_feminine,10,5832
4252,1464650,common_voice_en_33984511.mp3,Defence districts were referred to as ‘rayons’.,10,0,female_feminine,10,5040
4253,1464651,common_voice_en_33984518.mp3,This alliance was critical both to social justice goals and to suffrage.,15,5,female_feminine,10,6372
4254,1464653,common_voice_en_33984532.mp3,The show was hosted by Regine Velasquez.,10,0,female_feminine,10,5256
4255,1464655,common_voice_en_34061272.mp3,Clypeus transverse.,10,0,female_feminine,10,3744
4256,1464656,common_voice_en_34061278.mp3,This was common for many countries after the Black Death.,10,0,female_feminine,10,5076
4257,1464645,common_voice_en_33967574.mp3,The mission notably excluded the state of West Bengal.,10,0,female_feminine,10,6876
4258,1464964,common_voice_en_37153410.mp3,Many species of Bothrops exhibit tail vibration behavior when disturbed.,10,0,female_feminine,10,7380
4259,1464965,common_voice_en_37153411.mp3,Her grandparents had come to the United States and began their family in Michigan.,10,0,female_feminine,10,8280
4260,1464966,common_voice_en_37153412.mp3,"Tensile strength, that speaks to endurance, to maintaining in the imperfect world.",10,0,female_feminine,10,7956
4261,1464967,common_voice_en_37153413.mp3,The child audience were dressed in futuristic clothes and had gelled hair.,10,0,female_feminine,10,7740
4262,1464968,common_voice_en_37153414.mp3,"During her career, ""Dreadnought"" performed many varied missions.",10,0,female_feminine,10,6120
4263,1464969,common_voice_en_37153415.mp3,The Duke took his leave but urged the Pope to chastise both Cardinal-nephews.,10,0,female_feminine,10,6588
4264,1464970,common_voice_en_37153417.mp3,It is currently core helium burning through the triple alpha process.,10,0,female_feminine,10,5940
4265,1464971,common_voice_en_37153420.mp3,Others urge a military response.,10,0,female_feminine,10,5436
4266,1464809,common_voice_en_36434835.mp3,The various actors are mentioned and their objectives are given below.,10,0,female_feminine,10,6120
4267,1464976,common_voice_en_37153425.mp3,Zeilinger's group is now also developing a quantum cryptography prototype in collaboration with industry.,10,0,female_feminine,10,9360
4268,1464977,common_voice_en_37153426.mp3,"Boating is also popular, with a number of public boat ramps and piers provided.",10,0,female_feminine,10,6840
4269,1464978,common_voice_en_37153427.mp3,Passengers using the line have increased steadily at many stations on the line.,10,0,female_feminine,10,6876
4270,1464979,common_voice_en_37197233.mp3,"Upon its release, it received mixed reviews according to the review aggregation website Metacritic.",10,0,female_feminine,10,7596
4271,1464980,common_voice_en_37197234.mp3,"Additional results have been in Cuba, Nepal, and Nigeria.",10,0,female_feminine,10,6300
4272,1464985,common_voice_en_37247107.mp3,The Arran ferry passes close to the island.,10,0,female_feminine,10,4788
4273,1464988,common_voice_en_37247130.mp3,"In England, he received a basic education and learned to be a typesetter.",10,0,female_feminine,10,6264
4274,13703,common_voice_en_37732912.mp3,This list includes manuscripts in Latin and Anglo-Saxon.,12,2,female_feminine,10,5508
4275,1662578,common_voice_en_38005141.mp3,"It held talks, functions, debates and similar activities.",10,0,female_feminine,10,6516
4276,1464943,common_voice_en_37002267.mp3,There is no significant sexual dimorphism.,10,0,female_feminine,10,4644
4277,1464923,common_voice_en_36960062.mp3,"At the next possession, some other ancestor may declare himself.",10,0,female_feminine,10,7740
4278,1464924,common_voice_en_36960291.mp3,A lighthouse there serves oceangoing ships.,10,0,female_feminine,10,6336
4279,1464926,common_voice_en_36960293.mp3,"Brazil, Bolivia and Paraguay withdrew from the tournament.",10,0,female_feminine,10,6480
4280,1464930,common_voice_en_36962735.mp3,The Battle loser is evicted from the game.,10,0,female_feminine,10,4500
4281,1464932,common_voice_en_37002243.mp3,Ignatieff was defeated by Conservative Bernard Trottier in his own riding.,10,0,female_feminine,10,8496
4282,1464935,common_voice_en_37002247.mp3,Ryan composed some music in Cloneyhurke.,10,0,female_feminine,10,4788
4283,1464938,common_voice_en_37002255.mp3,The filioque clause spread through the Latin-literate West but not through the Greek-speaking East.,10,0,female_feminine,10,8316
4284,1464939,common_voice_en_37002256.mp3,Thus was founded the particular Church of Byzantine Rite Greek Catholics.,10,0,female_feminine,10,7416
4285,1464963,common_voice_en_37153409.mp3,They developed an ongoing dialogue about their ideas on art and metaphysics.,10,0,female_feminine,10,7056
4286,1464941,common_voice_en_37002265.mp3,Hatsushima sank by her stern.,10,0,female_feminine,10,3888
4287,1464942,common_voice_en_37002266.mp3,Ancient gold workings have been found in the area.,10,0,female_feminine,10,4284
4288,1464947,common_voice_en_37002506.mp3,"He was the son of Abijam, grandson of Rehoboam, and great-grandson of Solomon.",10,0,female_feminine,10,7776
4289,1464951,common_voice_en_37054026.mp3,He holds a bachelor's degree in pharmacy from the University of Manitoba.,10,0,female_feminine,10,6192
4290,1464954,common_voice_en_37081081.mp3,The company first concentrated on electric vehicles but soon began producing gasoline-engined cars.,10,0,female_feminine,10,8568
4291,1464955,common_voice_en_37081082.mp3,Nazareth Illit also has a regional engineering college.,10,0,female_feminine,10,6300
4292,1464958,common_voice_en_37081095.mp3,New technologies were developed to clean up nuclear waste sites.,10,0,female_feminine,10,5436
4293,1464927,common_voice_en_36960294.mp3,He was the first Academy graduate to return as superintendent.,10,0,female_feminine,10,6120
4294,1464962,common_voice_en_37153408.mp3,"Its affiliated preparatory school, Saint Martin's Ampleforth, is across the valley at Gilling Castle.",10,0,female_feminine,10,9180
4295,1464940,common_voice_en_37002264.mp3,Coeducational extension courses were started at Owensboro and eventually grew into its own campus.,10,0,female_feminine,10,8424
4296,1465038,common_voice_en_37569464.mp3,"The key idea is to show that these generate the ring ""R"" of invariants.",10,0,female_feminine,10,7740
4297,1465042,common_voice_en_38090551.mp3,"Diego, in Zorro costume, dances with Florinda at the ball.",10,0,female_feminine,10,6480
4298,1465047,common_voice_en_38353271.mp3,There were also a number of refugees from a war between two feudal houses.,10,0,female_feminine,10,6408
4299,1465053,common_voice_en_38505602.mp3,The seats are highly adjustable buckets with centre padding composed of many individual 'rolls'.,10,0,female_feminine,10,6840
4300,1465057,common_voice_en_38638913.mp3,"She later scored her first number-one single as a lead artist with ""Foolish"".",10,0,female_feminine,10,5220
4301,1465058,common_voice_en_38638914.mp3,The edge of the coin is imprinted with stars in relief.,10,0,female_feminine,10,4068
4302,1465063,common_voice_en_38680765.mp3,"He conducted frequent training sessions for ""Manorama"" journalists and other employees.",10,0,female_feminine,10,7164
4303,1465072,common_voice_en_38680783.mp3,The underside of the squirrel is always white-cream in colour.,10,0,female_feminine,10,5328
4304,1464990,common_voice_en_37247149.mp3,This in turn allowed for the creation of a uniform currency across Canada.,10,0,female_feminine,10,5544
4305,1522872,common_voice_en_37945606.mp3,"One bomber hit her hull amidships, bringing her to a dead stop.",10,0,female_feminine,10,5688
4306,1465081,common_voice_en_40107486.mp3,Hube was buried at the Invalid's Cemetery in Berlin.,10,0,female_feminine,10,5940
4307,1465090,common_voice_en_40877519.mp3,The names were displayed in a different font.,10,0,female_feminine,10,4320
4308,1465093,common_voice_en_40929600.mp3,Dickson observed and marvelled.,10,0,female_feminine,10,5508
4309,354790,common_voice_en_637954.mp3,The oasis is neutral ground.,10,0,female_feminine,10,2472
4310,1659532,common_voice_en_37950307.mp3,The flowers have five reflexed petals and an elevated central crown.,12,2,female_feminine,10,7776
4311,1660950,common_voice_en_37974779.mp3,"Its capital city, administrative and religious center was Thermo.",10,0,female_feminine,10,6696
4312,159888,common_voice_en_19193.mp3,The greatest authority on meteorites stated that the height of its first appearance was about ninety or one hundred miles.,10,0,female_feminine,10,11088
4313,764778,common_voice_en_38023312.mp3,She was always a strong voice for rural issues.,10,0,female_feminine,10,4140
4314,1465077,common_voice_en_38944655.mp3,It is the tenth largest lake in Sweden.,10,0,female_feminine,10,6300
4315,1464992,common_voice_en_37267717.mp3,"Commonly, there is one monetary authority for one country with its currency.",10,0,female_feminine,10,7092
4316,1464995,common_voice_en_37267720.mp3,"Most of the overseas provinces were represented, especially the most populous regions.",10,0,female_feminine,10,7020
4317,1464997,common_voice_en_37267724.mp3,"Despite this, some bacterial strains that are resistant even to such combinations have emerged.",10,0,female_feminine,10,7056
4318,1464998,common_voice_en_37267730.mp3,"They knew each other as teenagers, and had no contact for many years.",10,0,female_feminine,10,6408
4319,1464999,common_voice_en_37267731.mp3,Its main building is a huge pyramid containing an entire city inside.,10,0,female_feminine,10,5904
4320,1465000,common_voice_en_37267732.mp3,More research is needed to understand this practice and intervene effectively.,10,0,female_feminine,10,5832
4321,1465001,common_voice_en_37267733.mp3,Claremont House is now occupied by the early years department.,10,0,female_feminine,10,4608
4322,1465002,common_voice_en_37267734.mp3,What do you do in real life?,10,0,female_feminine,10,3708
4323,1465005,common_voice_en_37267743.mp3,Guests also take the raft to gain access to Tom Sawyer Island in Florida.,10,0,female_feminine,10,4788
4324,1465037,common_voice_en_37468521.mp3,The southeastern end of the strait is marked by Austin Bay.,10,0,female_feminine,10,3600
4325,704957,common_voice_en_32274220.mp3,The open timbered roof has principals of pitch pine and red deal.,10,0,female_feminine,10,6660
4326,1465010,common_voice_en_37267758.mp3,Each side of the marker contains pictures of the original campus and the plaza.,10,0,female_feminine,10,5580
4327,1465011,common_voice_en_37267760.mp3,Only those too sick to walk were left behind.,10,0,female_feminine,10,3564
4328,1465012,common_voice_en_37267761.mp3,Margaret was as pious privately as she was publicly.,10,0,female_feminine,10,4500
4329,1465013,common_voice_en_37267766.mp3,This property had been owned by the late Frank Whiting.,10,0,female_feminine,10,4356
4330,1465014,common_voice_en_37267768.mp3,Collection of bush rocks for gardens and landscaping removes habitat for reptiles.,10,0,female_feminine,10,6516
4331,1465016,common_voice_en_37267770.mp3,He also acted as interpreter.,10,0,female_feminine,10,2700
4332,1465025,common_voice_en_37307347.mp3,This decision was criticized by internet watch groups for being an extremely selfish act.,10,0,female_feminine,10,6516
4333,1465034,common_voice_en_37468494.mp3,"The business estate, museum of Brooklands and Brooklands College adjoin the other sides.",10,0,female_feminine,10,7776
4334,1465008,common_voice_en_37267756.mp3,A random draw was made to determine the pole for the race.,10,0,female_feminine,10,3816
4335,1464830,common_voice_en_36498504.mp3,Waves may also form in dry air without cloud markers.,10,0,female_feminine,10,5040
4336,1464831,common_voice_en_36510108.mp3,"Here, is the similarity of characters ""a"" and ""b"".",10,0,female_feminine,10,5256
4337,1464832,common_voice_en_36510109.mp3,"His subsequent work dealt with illumination models, light transport, rendering, and sampling and filtering.",10,0,female_feminine,10,9288
4338,1464834,common_voice_en_36510112.mp3,In the meantime Rogan changed his plans on retirement.,10,0,female_feminine,10,5328
4339,1464835,common_voice_en_36510136.mp3,A few months later he was elected president of the Puerto Rico Olympic Committee.,10,0,female_feminine,10,6516
4340,1464836,common_voice_en_36510137.mp3,"His memoirs were titled ""Never a Normal Man"".",10,0,female_feminine,10,4860
4341,1464837,common_voice_en_36510138.mp3,The committee announces a short list in April of each year.,10,0,female_feminine,10,4536
4342,1464838,common_voice_en_36510139.mp3,"In order to stabilize the team, a third member, Puke, was introduced.",10,0,female_feminine,10,5868
4343,1464922,common_voice_en_36960060.mp3,Saint Blaise is also associated with Stretford in Lancashire.,15,5,female_feminine,10,7200
4344,1464844,common_voice_en_36523813.mp3,Two months later Owen began his law practice in Bessemer.,10,0,female_feminine,10,5040
4345,1464845,common_voice_en_36523814.mp3,"Goldberg later studied at Pratt Institute, where he majored in illustration.",10,0,female_feminine,10,6480
4346,1464846,common_voice_en_36523817.mp3,"The Bruins outbid Vadnais' old club, the Canadiens, to secure his services.",10,0,female_feminine,10,10188
4347,1464847,common_voice_en_36816201.mp3,McAdoo contains the picturesque Silver Brook Meadow.,10,0,female_feminine,10,6336
4348,1464849,common_voice_en_36816205.mp3,Both candidates increased their popular vote in the hotly contested race.,10,0,female_feminine,10,7596
4349,1464850,common_voice_en_36816209.mp3,These seals were mainly impressed on documents using black ink.,10,0,female_feminine,10,5364
4350,1464852,common_voice_en_36816217.mp3,"In Africa, he also created some stamp series for Mauritania and Rwanda.",10,0,female_feminine,10,8064
4351,1464853,common_voice_en_36824479.mp3,It is prepared commercially by oxidizing propargyl alcohol at a lead electrode.,10,0,female_feminine,10,6876
4352,1464854,common_voice_en_36824481.mp3,"Still, holding the title as the longest procession in the Philippines.",10,0,female_feminine,10,5868
4353,1464839,common_voice_en_36510141.mp3,"In Hanna Suchocka's government, he was the chief of the Council of Ministers office.",10,0,female_feminine,10,6336
4354,1464811,common_voice_en_36434837.mp3,They were upset in the Regional Finals by Madison East High School.,10,0,female_feminine,10,5868
4355,1544704,common_voice_en_31924983.mp3,Markets are held on Mondays and Thursdays.,10,0,female_feminine,10,3240
4356,1464812,common_voice_en_36434838.mp3,Tim Booth's desire to re-record some of his vocals caused friction in the studio.,10,0,female_feminine,10,7956
4357,1464813,common_voice_en_36434839.mp3,He lost the fight via submission in round one.,10,0,female_feminine,10,4968
4358,1464814,common_voice_en_36498445.mp3,They treat these dolls as if they were real children.,10,0,female_feminine,10,4320
4359,1464815,common_voice_en_36498446.mp3,The final stage of runs from Timbersbrook to Kidsgrove.,10,0,female_feminine,10,6408
4360,1464816,common_voice_en_36498448.mp3,The rifle loopholes were also filled.,10,0,female_feminine,10,4248
4361,1464817,common_voice_en_36498460.mp3,His wife and children may not have their hair cut in his absence.,10,0,female_feminine,10,5436
4362,1464818,common_voice_en_36498461.mp3,In Java the afterbirth is called the brother or sister of the infant.,10,0,female_feminine,10,5976
4363,1464829,common_voice_en_36498502.mp3,In a dry season their lot is a hard one.,10,0,female_feminine,10,4320
4364,1464820,common_voice_en_36498463.mp3,Any question is clarified by bringing it down to the simplest terms.,10,0,female_feminine,10,6696
4365,1464821,common_voice_en_36498464.mp3,"He drank off two more glasses of wine, one after another.",10,0,female_feminine,10,4896
4366,1464822,common_voice_en_36498470.mp3,A year later he became Paramount's youngest staff writer.,10,0,female_feminine,10,5580
4367,1464824,common_voice_en_36498472.mp3,A barren wife infects her husband's garden with her own sterility.,10,0,female_feminine,10,5868
4368,1522066,common_voice_en_36842518.mp3,The constant is called the coefficient of proportionality or proportionality constant.,10,0,female_feminine,10,5724
4369,1464825,common_voice_en_36498473.mp3,The inner walls and the crater floor are rugged and irregular.,10,0,female_feminine,10,4716
4370,1464794,common_voice_en_35347169.mp3,"Several aspects of the episode itself also parody ""Star Trek"".",10,0,female_feminine,10,6300
4371,1464827,common_voice_en_36498500.mp3,"Meanwhile, legal aid Marybeth Cogan uncovers a conspiracy to smear Santos.",10,0,female_feminine,10,9000
4372,1464828,common_voice_en_36498501.mp3,At night she sleeps with them close to her head.,10,0,female_feminine,10,4248
4373,1464819,common_voice_en_36498462.mp3,He hoped that the flax would grow as high as he flung the seedbag.,10,0,female_feminine,10,6120
4374,1464899,common_voice_en_36911476.mp3,Things have changed greatly in the seventy years since the expedition.,10,0,female_feminine,10,5868
4375,1464900,common_voice_en_36911478.mp3,The moon's diameter is just about one-fourth that of the earth.,10,0,female_feminine,10,5220
4376,1464901,common_voice_en_36911479.mp3,"If such a fire went out, it was lighted again by friction.",10,0,female_feminine,10,5256
4377,1464902,common_voice_en_36911481.mp3,The people fetch a light to kindle the fire on their own hearths.,10,0,female_feminine,10,5688
4378,1464903,common_voice_en_36911482.mp3,The dragon's blood was thought to be a sure protection against witchcraft.,10,0,female_feminine,10,5256
4379,1464904,common_voice_en_36911483.mp3,The fallacy of such a belief is plain enough to us.,10,0,female_feminine,10,4788
4380,1464906,common_voice_en_36911486.mp3,A king of this sort lives hedged in by a ceremonious etiquette.,10,0,female_feminine,10,6876
4381,1464907,common_voice_en_36911487.mp3,The constables on duty are prohibited from drinking coconut water.,10,0,female_feminine,10,5328
4382,1464859,common_voice_en_36824852.mp3,She will operate out of the Heybridge Basin.,10,0,female_feminine,10,3852
4383,1464879,common_voice_en_36911453.mp3,They were expected to be a source of fecundity to the cattle.,10,0,female_feminine,10,5580
4384,1464912,common_voice_en_36911493.mp3,For further improvement we must trust to the increased and excellent staff.,10,0,female_feminine,10,5760
4385,1464913,common_voice_en_36911494.mp3,A fire of oak wood burned day and night in his honor.,10,0,female_feminine,10,4608
4386,1464915,common_voice_en_36911497.mp3,They fling a chopper and a plate into the water.,10,0,female_feminine,10,4536
4387,1464916,common_voice_en_36911498.mp3,Some regarded the bond as even closer and more sacred.,10,0,female_feminine,10,4320
4388,1464917,common_voice_en_36911502.mp3,"The social standing of a medicine-man is, on the whole, a desirable one.",10,0,female_feminine,10,6156
4389,1464918,common_voice_en_36911503.mp3,The custom is or was to bring in a new May-tree each year.,10,0,female_feminine,10,5580
4390,1464919,common_voice_en_36911504.mp3,Their souls passed into the trees and left the villagers in peace.,10,0,female_feminine,10,5040
4391,1464920,common_voice_en_36960058.mp3,"Whitaker is married to Alexis Gelber, a former long-time editor at ""Newsweek"".",10,0,female_feminine,10,10476
4392,1464908,common_voice_en_36911488.mp3,"If he was still obstinate, they plunged him into the water.",10,0,female_feminine,10,5256
4393,1464860,common_voice_en_36824853.mp3,Bloomfield's younger brother Billy was also a professional footballer for Brentford.,10,0,female_feminine,10,6300
4394,1464863,common_voice_en_36860118.mp3,The game was written and published by Simon W Hessel.,10,0,female_feminine,10,6336
4395,1464864,common_voice_en_36860124.mp3,"In a given expression, the actual function referenced is determined by the context.",10,0,female_feminine,10,8856
4396,1464865,common_voice_en_36860141.mp3,Domvile was a prolific diarist.,10,0,female_feminine,10,4428
4397,1464869,common_voice_en_36910232.mp3,There is an unfailing supply of aspirants to the office.,10,0,female_feminine,10,6516
4398,1464876,common_voice_en_36911450.mp3,A more elaborate form has smaller semicircle inserted in the four angles.,10,0,female_feminine,10,6948
4399,1464877,common_voice_en_36911451.mp3,I'm the one that has to stand all the punishment.,10,0,female_feminine,10,4860
4400,1464878,common_voice_en_36911452.mp3,If rain does not come at the proper,10,0,female_feminine,10,5616
4401,1464880,common_voice_en_36911455.mp3,The cutters could be given copies of the plan for their guidance.,10,0,female_feminine,10,4860
4402,1464897,common_voice_en_36911474.mp3,He occupies a higher post here than the Pope does in Catholic Europe.,10,0,female_feminine,10,5220
4403,1464883,common_voice_en_36911458.mp3,"During this procession, none of the girls may stand still.",10,0,female_feminine,10,5400
4404,1464884,common_voice_en_36911459.mp3,The kingship is elective within the limits of the royal blood.,10,0,female_feminine,10,5760
4405,1464886,common_voice_en_36911462.mp3,The country was overspread wtih dense forests of tall and stately oaks.,10,0,female_feminine,10,6948
4406,1464888,common_voice_en_36911465.mp3,I have cited many instances of this belief in serpent-shaped spirits of water.,10,0,female_feminine,10,7380
4407,1464889,common_voice_en_36911466.mp3,The missionaries are forced to use the native word for king.,10,0,female_feminine,10,4860
4408,1464891,common_voice_en_36911468.mp3,"In time of drought, the angry people assemble and kill him.",10,0,female_feminine,10,4680
4409,1464892,common_voice_en_36911469.mp3,He bequeathed to his descendants the dignity he had won.,10,0,female_feminine,10,5508
4410,1464858,common_voice_en_36824770.mp3,"Credited as L. Mah, Leslie Mah again plays bass and sings.",10,0,female_feminine,10,5688
4411,1464896,common_voice_en_36911473.mp3,Hemlock is not used as an anaphrodisiac at the present day.,10,0,female_feminine,10,5256
4412,1464882,common_voice_en_36911457.mp3,Every village and every town is turned into a sort of garden.,10,0,female_feminine,10,5796
4413,1464508,common_voice_en_33165584.mp3,The capital of the Union of Comoros is Moroni.,10,0,female_feminine,10,5256
4414,1464507,common_voice_en_33165582.mp3,"She called the quick process of joining the series ""insane"".",10,0,female_feminine,10,5796
4415,1464506,common_voice_en_33165581.mp3,It will function under the Integrated Defence Staff.,10,0,female_feminine,10,4896
4416,1464505,common_voice_en_33165580.mp3,She particularly enjoyed baking bread.,10,0,female_feminine,10,5076
4417,1464502,common_voice_en_33165576.mp3,The Ritz was constructed by cinema architects Verity and Beverley for Union Cinemas.,10,0,female_feminine,10,7668
4418,1223691,common_voice_en_35261700.mp3,The club lasted four seasons in Bridgend before relocating to Wrexham under new ownership.,10,0,female_feminine,10,8532
4419,1464501,common_voice_en_33165575.mp3,He also participated in three Copa Paraguay games that year.,10,0,female_feminine,10,6228
4420,1464500,common_voice_en_33165574.mp3,He was one of the most valued Irish Crown servants of his generation.,10,0,female_feminine,10,6336
4421,1464498,common_voice_en_33165572.mp3,Numbers in brackets denote the World ranking.,10,0,female_feminine,10,5076
4422,1464497,common_voice_en_33165571.mp3,Prior to planting seeds should be soaked or scarified.,10,0,female_feminine,10,6048
4423,1223582,common_voice_en_32762863.mp3,They lost in the quarterfinal round of the Metro Tournament to Louisville.,10,0,female_feminine,10,6120
4424,1464555,common_voice_en_33322101.mp3,Biogas power in Ukraine is growing.,10,0,female_feminine,10,5796
4425,1464496,common_voice_en_33165570.mp3,They were very difficult moments in my life.,10,0,female_feminine,10,5040
4426,1464495,common_voice_en_33165569.mp3,The anterior chamber angle is the structure which determines the anterior chamber depth.,10,0,female_feminine,10,7236
4427,1530292,common_voice_en_32254198.mp3,The game concludes in one of twenty different endings.,10,0,female_feminine,10,5040
4428,1464492,common_voice_en_33165566.mp3,Yung also appeared in drama films and comedy films.,10,0,female_feminine,10,5976
4429,1464491,common_voice_en_33165565.mp3,It is the first daily newspaper published by foreigners in Beiping.,10,0,female_feminine,10,6336
4430,1464490,common_voice_en_33165564.mp3,He was the founder executive member of Amnesty International.,10,0,female_feminine,10,6660
4431,1464489,common_voice_en_33165563.mp3,Its leader was Nancy Steele.,10,0,female_feminine,10,4428
4432,1464455,common_voice_en_33077923.mp3,Denotes player spent time with another team before joining the Rangers.,10,0,female_feminine,10,6120
4433,1464486,common_voice_en_33165560.mp3,Her character performs sarcastically on her short term memory to spread joy and laughter.,10,0,female_feminine,10,7308
4434,1464485,common_voice_en_33165558.mp3,"One example identified by ""Wired"" is the Linux operating system.",10,0,female_feminine,10,6876
4435,1464483,common_voice_en_33165555.mp3,Here he defended his Doctor of Technology Thesis and became an associate professor.,10,0,female_feminine,10,8316
4436,1464556,common_voice_en_33322102.mp3,His education was interrupted by the Second World War.,10,0,female_feminine,10,5688
4437,1464482,common_voice_en_33165554.mp3,Balderston believed that one of the brigs was an English prize.,10,0,female_feminine,10,6408
4438,1464558,common_voice_en_33322112.mp3,Wei studied at North China University (later renamed as Renmin University of China).,10,0,female_feminine,10,9648
4439,1464481,common_voice_en_33165553.mp3,He also received an Efficiency Decoration.,10,0,female_feminine,10,5976
4440,1464479,common_voice_en_33114991.mp3,Tam moved to Macau aged seven.,10,0,female_feminine,10,4968
4441,1464561,common_voice_en_33382530.mp3,Ballymac Ball continued his impressive form by successfully defending his Laurels title.,10,0,female_feminine,10,8748
4442,1464474,common_voice_en_33078048.mp3,He also took courses in anatomy from Rudolf Virchow.,10,0,female_feminine,10,6048
4443,1464493,common_voice_en_33165567.mp3,Severini studies accounting.,10,0,female_feminine,10,4176
4444,1521319,common_voice_en_36612984.mp3,"They lost, Volkmar was slain, and the war altar of Sigmar was cast down.",10,0,female_feminine,10,6192
4445,1464547,common_voice_en_33319352.mp3,That will never be compromised.,10,0,female_feminine,10,3420
4446,1464545,common_voice_en_33319350.mp3,Shackleton also worked with Walter Gilbert in writing his memoirs.,10,0,female_feminine,10,5796
4447,566817,common_voice_en_53485.mp3,Gold would lose its value.,10,0,female_feminine,10,4176
4448,1464544,common_voice_en_33319327.mp3,The festival is held during the lunar month of Bhadra.,10,0,female_feminine,10,7020
4449,1464543,common_voice_en_33319326.mp3,Users can select Night mode and Pro mode as well.,10,0,female_feminine,10,4500
4450,1464549,common_voice_en_33322089.mp3,The main setting will be Australia.,10,0,female_feminine,10,4536
4451,1464542,common_voice_en_33319325.mp3,The site has also hosted the Frontier Days festival and Movies in the Park.,10,0,female_feminine,10,5940
4452,1464540,common_voice_en_33319323.mp3,He has featured in different issues of prestigious vogue magazines.,10,0,female_feminine,10,5688
4453,1464536,common_voice_en_33319293.mp3,Several boats that survived the war later served in the Italian Navy.,10,0,female_feminine,10,6876
4454,1464534,common_voice_en_33319222.mp3,Groothuis joined the Ministry of Defence thereafter.,10,0,female_feminine,10,4500
4455,1464533,common_voice_en_33319219.mp3,All rounds were held in Italy.,10,0,female_feminine,10,4608
4456,1464550,common_voice_en_33322090.mp3,The temple is renowned for its magnificent wood carvings made of plankton.,10,0,female_feminine,10,6408
4457,1464532,common_voice_en_33307107.mp3,The dormitories are run under the supervision of the Housing and Dormitory Committee.,10,0,female_feminine,10,6408
4458,1464530,common_voice_en_33307104.mp3,Occurs in savannahs and montane forests in East Africa and Southeastern Nigeria.,10,0,female_feminine,10,7308
4459,1464509,common_voice_en_33165585.mp3,"The capture of ""Union"" took place off Bassa.",10,0,female_feminine,10,4860
4460,1464528,common_voice_en_33307082.mp3,This was won by architect Ove Bang.,10,0,female_feminine,10,7380
4461,1464527,common_voice_en_33307080.mp3,Nomura did not graduate from secondary school.,10,0,female_feminine,10,4968
4462,1464526,common_voice_en_33307079.mp3,Lee danced and toured with George Washington Smith.,10,0,female_feminine,10,5148
4463,1464525,common_voice_en_33307078.mp3,She is of Polish–Bulgarian descent and apart from Polish speaks fluent Bulgarian.,10,0,female_feminine,10,6516
4464,1464519,common_voice_en_33183604.mp3,"The two also ""trade bars"" about their haters.",10,0,female_feminine,10,7380
4465,1464524,common_voice_en_33183647.mp3,She formed part of the Frente de Todos bloc.,10,0,female_feminine,10,6948
4466,1464523,common_voice_en_33183646.mp3,It was the first television play produced in Brisbane.,10,0,female_feminine,10,8316
4467,1464487,common_voice_en_33165561.mp3,His poetry focused much on the glory of Muslims as well as village life.,10,0,female_feminine,10,6660
4468,1464518,common_voice_en_33183603.mp3,He himself escaped the disaster without injury.,10,0,female_feminine,10,7668
4469,1464516,common_voice_en_33183584.mp3,Chaloner then worked initially in the public relations of Field Marshal Bernard Montgomery.,10,0,female_feminine,10,9216
4470,1464552,common_voice_en_33322092.mp3,She was born without her lower left leg and lower left arm.,10,0,female_feminine,10,6156
4471,1464514,common_voice_en_33183581.mp3,He is the younger brother of cricketer Leon Soma.,10,0,female_feminine,10,6480
4472,1464513,common_voice_en_33165590.mp3,He was subsequently granted refugee status.,10,0,female_feminine,10,4608
4473,1464511,common_voice_en_33165588.mp3,Teams will participate in several levels of competition.,10,0,female_feminine,10,5040
4474,1464554,common_voice_en_33322099.mp3,The balut dice game was invented at the hotel.,10,0,female_feminine,10,7020
4475,1464529,common_voice_en_33307103.mp3,The capacity of rooms in evacuation shelters was limited to three families.,10,0,female_feminine,10,7776
4476,1464466,common_voice_en_33078010.mp3,Jones would be the one to soon after confess to the crime.,10,0,female_feminine,10,4968
4477,1464456,common_voice_en_33077924.mp3,Frank Mansur donated the house to.,10,0,female_feminine,10,4500
4478,1464470,common_voice_en_33078030.mp3,An inauguration ceremony was held for her in September.,10,0,female_feminine,10,4968
4479,1464473,common_voice_en_33078047.mp3,It is one of the oldest schools in the whole country.,10,0,female_feminine,10,4356
4480,567296,common_voice_en_83156.mp3,"We don't know what's in the confounded thing, do you?",10,0,female_feminine,10,3336
4481,1464467,common_voice_en_33078011.mp3,Louisville played as members of the Colorado State League.,10,0,female_feminine,10,4500
4482,1464464,common_voice_en_33078007.mp3,Games and published by Gamera Interactive.,10,0,female_feminine,10,4608
4483,1464460,common_voice_en_33077997.mp3,The hospital was named for the neighborhood.,10,0,female_feminine,10,4140
4484,1464562,common_voice_en_33382532.mp3,He took pole for both races and finished both races in second place.,10,0,female_feminine,10,5580
4485,1464462,common_voice_en_33078000.mp3,France went on to beat England to win the tournament.,10,0,female_feminine,10,4608
4486,1520981,common_voice_en_36410491.mp3,It is under the responsibility of the Ministry of Local Government and Outer Islands.,10,0,female_feminine,10,5580
4487,1489275,common_voice_en_38734872.mp3,Not all leases result in productive mines.,12,2,female_feminine,10,4716
4488,567278,common_voice_en_83138.mp3,"They looked for the fallen mass, but found nothing.",10,0,female_feminine,10,3408
4489,944578,common_voice_en_32836500.mp3,She was finally chosen by vote of the Karolinska lecturers.,10,0,female_feminine,10,5148
4490,1464423,common_voice_en_33054313.mp3,French customs relating to feudal warfare were adopted elsewhere.,10,0,female_feminine,10,5868
4491,1464459,common_voice_en_33077971.mp3,It was quickly demolished after this.,10,0,female_feminine,10,4248
4492,1464439,common_voice_en_33055827.mp3,The quality of fen biodiversity should be monitored for signs of change.,10,0,female_feminine,10,7236
4493,290644,common_voice_en_2752.mp3,The Englishman's eyes lit up.,12,2,female_feminine,10,4416
4494,1464453,common_voice_en_33056002.mp3,He is buried in the Loschwitz Cemetery.,10,0,female_feminine,10,4608
4495,1464472,common_voice_en_33078045.mp3,She died in Rome.,10,0,female_feminine,10,2196
4496,1464457,common_voice_en_33077925.mp3,They could do foolish things because of lack of literacy and education.,10,0,female_feminine,10,5580
4497,371368,common_voice_en_31303649.mp3,Susan Vogel was born in Detroit.,9,0,female_feminine,9,4500
4498,301868,common_voice_en_63619.mp3,I thought about the difficulties in translation that might arise.,9,0,female_feminine,9,5592
4499,682938,common_voice_en_44611.mp3,I have the diet of a kid who found twenty dollars.,9,0,female_feminine,9,4584
4500,1150655,common_voice_en_26249.mp3,"They must be used to their new shepherd, and have probably already forgotten me.",10,1,female_feminine,9,4392
4501,1375623,common_voice_en_38325860.mp3,The path goes through a richly cultivated district of wheat and vines.,9,0,female_feminine,9,7308
4502,864165,common_voice_en_36881915.mp3,It was their first album to feature Joseph Williams on lead vocals.,9,0,female_feminine,9,5544
4503,999567,common_voice_en_32877045.mp3,Originally meetings of Sligo County Council were held at Sligo Courthouse.,9,0,female_feminine,9,7020
4504,220028,common_voice_en_20285954.mp3,"Owen's first job was as a graduate trainee on the ""Doncaster Evening Post"".",9,0,female_feminine,9,6048
4505,101994,common_voice_en_34210.mp3,"Besides that, there was a heap of bicycles.",9,0,female_feminine,9,3888
4506,663782,common_voice_en_101076.mp3,It had a diameter of about thirty yards.,9,0,female_feminine,9,4800
4507,637796,common_voice_en_62458.mp3,"It was starlight, and I explained the Signs of the Zodiac to her.",9,0,female_feminine,9,4296
4508,1150657,common_voice_en_26251.mp3,"The Englishman prodded him, and the boy asked her about the man who cured people's illnesses.",9,0,female_feminine,9,5016
4509,312001,common_voice_en_88167.mp3,Fill this place with a sandstorm so strong that it blots out the sun.,9,0,female_feminine,9,4056
4510,1077684,common_voice_en_31766922.mp3,She is the cousin of actor Denis Bernard.,9,0,female_feminine,9,3528
4511,220027,common_voice_en_20285932.mp3,The origin of the name Two Egg is obscure.,9,0,female_feminine,9,4752
4512,590934,common_voice_en_586010.mp3,YOU WANNA TAKE THIS OUTSIDE?,9,0,female_feminine,9,3024
4513,713353,common_voice_en_20285267.mp3,This time is also the fastest non-winning time in history.,9,0,female_feminine,9,4968
4514,1077696,common_voice_en_31766954.mp3,An advertisement for Lucky Me!,9,0,female_feminine,9,3348
4515,1150662,common_voice_en_26256.mp3,We always observe the Tradition.,9,0,female_feminine,9,2544
4516,1150448,common_voice_en_26042.mp3,I hold the power of life and death for every person I take with me.,9,0,female_feminine,9,4896
4517,159885,common_voice_en_19190.mp3,Ogilvy watched till one and then gave up.,9,0,female_feminine,9,5208
4518,1150667,common_voice_en_26261.mp3,The boy awoke as the sun rose.,9,0,female_feminine,9,2616
4519,1084558,common_voice_en_35117794.mp3,Silverberg recommended Ted White as a replacement.,9,0,female_feminine,9,5076
4520,1375448,common_voice_en_38266270.mp3,He is brought up each autumn to be renewed.,9,0,female_feminine,9,4716
4521,1672007,common_voice_en_20286207.mp3,This county abuts the Mexican border.,9,0,female_feminine,9,4752
4522,190297,common_voice_en_124218.mp3,The newspaper articles had prepared everyone for the reception of the idea.,10,1,female_feminine,9,4416
4523,345469,common_voice_en_26986545.mp3,"The governor worked well with frontier traders, explorers, and missionaries.",9,0,female_feminine,9,8676
4524,637793,common_voice_en_62455.mp3,The top had certainly ceased to rotate.,9,0,female_feminine,9,2808
4525,375888,common_voice_en_37636.mp3,"It was starlight, and I explained the Signs of the Zodiac to her.",9,0,female_feminine,9,5688
4526,1084596,common_voice_en_35117960.mp3,He knew now quite clearly.,9,0,female_feminine,9,3384
4527,637814,common_voice_en_62476.mp3,"They looked for the fallen mass, but found nothing.",9,0,female_feminine,9,3408
4528,1150625,common_voice_en_26219.mp3,"It was seen early in the morning, rushing over eastward.",9,0,female_feminine,9,3408
4529,371076,common_voice_en_30674081.mp3,The plant prefers moist conditions but can tolerate some dryness.,9,0,female_feminine,9,6228
4530,883962,common_voice_en_36481372.mp3,"Further, the Model United Nations is another program that is widely participated in.",9,0,female_feminine,9,7488
4531,743601,common_voice_en_37470800.mp3,"Knightley has an elder brother, Caleb.",9,0,female_feminine,9,5148
4532,202636,common_voice_en_39750684.mp3,It is sometimes included in the Wester Hailes area.,9,0,female_feminine,9,6696
4533,743584,common_voice_en_37470746.mp3,It was published in German and English.,9,0,female_feminine,9,4500
4534,637816,common_voice_en_62478.mp3,"Some went away while I was there, and other people came.",9,0,female_feminine,9,3648
4535,615294,common_voice_en_36851508.mp3,The tea also gains a distinct aroma from the covering process.,9,0,female_feminine,9,6192
4536,883852,common_voice_en_33342249.mp3,Only regular season losing streaks lasting fourteen or more games are included.,9,0,female_feminine,9,6948
4537,1084721,common_voice_en_35120993.mp3,Hilton Head Island has been known for championship golf courses for decades.,9,0,female_feminine,9,5904
4538,489364,common_voice_en_71809.mp3,"When he saw Henderson in his garden, he called over the fence and made himself understood.",9,0,female_feminine,9,7104
4539,567270,common_voice_en_83130.mp3,Then suddenly he noticed it with a start.,9,0,female_feminine,9,3120
4540,1084552,common_voice_en_35117787.mp3,She makes kids do exercise machines on Tuesdays and box each other on Thursdays.,9,0,female_feminine,9,6948
4541,1084553,common_voice_en_35117788.mp3,At other times the island has been washed away completely.,9,0,female_feminine,9,5040
4542,418623,common_voice_en_59118.mp3,"One can imagine these two, covered with sand, running up the little street in the bright sunlight.",9,0,female_feminine,9,5352
4543,864097,common_voice_en_35299135.mp3,All teams ran the Chevrolet Camaro.,9,0,female_feminine,9,3708
4544,1077769,common_voice_en_32129166.mp3,She was born in the department of Tizi Ouzou.,9,0,female_feminine,9,4068
4545,797237,common_voice_en_30453355.mp3,Ben Connor was the head coach.,9,0,female_feminine,9,4392
4546,713326,common_voice_en_20285115.mp3,He also pleaded guilty to seven counts of attempted murder.,9,0,female_feminine,9,4704
4547,793856,common_voice_en_37038142.mp3,It is a serious comedy about the deterioration of ingenuity and art.,9,0,female_feminine,9,9216
4548,711829,common_voice_en_42064.mp3,The old man said nothing.,9,0,female_feminine,9,5544
4549,538857,common_voice_en_59351.mp3,"I was scared, but wasted no time in going out and crossing the bridge to the sand pits.",9,0,female_feminine,9,5664
4550,398698,common_voice_en_83419.mp3,"Finally, a young woman approached who was not dressed in black.",9,0,female_feminine,9,6696
4551,1375806,common_voice_en_38354465.mp3,"Its broadcasting headquarters are located in Montreal, Quebec.",9,0,female_feminine,9,7416
4552,1150553,common_voice_en_26147.mp3,"What are they doing? the old man asked, pointing at the people in the plaza.",9,0,female_feminine,9,4464
4553,999537,common_voice_en_32876975.mp3,The firm was later continued by his son.,9,0,female_feminine,9,3744
4554,682972,common_voice_en_44645.mp3,The greatest authority on meteorites stated that the height of its first appearance was about ninety or one hundred miles.,9,0,female_feminine,9,7608
4555,797198,common_voice_en_30453316.mp3,The species is common throughout appropriate habitat in its range.,9,0,female_feminine,9,5832
4556,489342,common_voice_en_71787.mp3,"And at that I told him, and he took my place.",10,1,female_feminine,9,4464
4557,1150408,common_voice_en_26002.mp3,He was just and good.,9,0,female_feminine,9,2712
4558,1150534,common_voice_en_26128.mp3,Camels are traitorous: they walk thousands of paces and never seem to tire.,9,0,female_feminine,9,4776
4559,1150551,common_voice_en_26145.mp3,"Well, interpret the dream, he said.",9,0,female_feminine,9,2736
4560,1065832,common_voice_en_18169695.mp3,That's a fair amount of loot.,10,1,female_feminine,9,2760
4561,564893,common_voice_en_557394.mp3,"I was scared, but wasted no time in going out and crossing the bridge to the sand pits.",9,0,female_feminine,9,6792
4562,713330,common_voice_en_20285155.mp3,The head-case terminates in a short pointed snout.,9,0,female_feminine,9,5400
4563,691201,common_voice_en_148778.mp3,It spread through the planet's atmosphere and obscured its more familiar features.,9,0,female_feminine,9,7512
4564,793888,common_voice_en_37038188.mp3,"Keenlyside was born in London, the son of Raymond and Ann Keenlyside.",9,0,female_feminine,9,9504
4565,682975,common_voice_en_44648.mp3,Even then he hardly understood what this meant.,9,0,female_feminine,9,4248
4566,713335,common_voice_en_20285172.mp3,Excavation and replacement of the anodes is required as they corrode.,9,0,female_feminine,9,6024
4567,1150394,common_voice_en_25988.mp3,"We're refugees from the tribal wars, and we need money, the other figure said.",9,0,female_feminine,9,4632
4568,1077612,common_voice_en_31751859.mp3,The main body of the church is in the form of an octagon.,9,0,female_feminine,9,4896
4569,557281,common_voice_en_608121.mp3,I got drunk yesterday and thought I built a super computer.,10,1,female_feminine,9,4632
4570,481071,common_voice_en_36520446.mp3,Beta returns to Alpha to tell her that Negan is dead when Negan emerges.,9,0,female_feminine,9,6696
4571,1150430,common_voice_en_26024.mp3,"His heart squeezed, as if his chest had suddenly compressed it.",9,0,female_feminine,9,3864
4572,1150379,common_voice_en_25973.mp3,"From atop its walls, one can catch a glimpse of Africa.",9,0,female_feminine,9,3816
4573,711813,common_voice_en_42048.mp3,"We are part of that soul, so we rarely recognize that it is working for us.",9,0,female_feminine,9,7224
4574,1077727,common_voice_en_31767066.mp3,She would go on to lose the belt by unanimous decision.,9,0,female_feminine,9,4788
4575,306301,common_voice_en_38632.mp3,I wished I had a light to smoke by.,9,0,female_feminine,9,3192
4576,306299,common_voice_en_38630.mp3,The boy didn't say anything.,9,0,female_feminine,9,2472
4577,454586,common_voice_en_60063.mp3,"Finally, a young woman approached who was not dressed in black.",9,0,female_feminine,9,6984
4578,1150484,common_voice_en_26078.mp3,The alchemist turned to the boy.,9,0,female_feminine,9,2448
4579,1084693,common_voice_en_35120851.mp3,"Today, most islanders are crofters with income from sheep farming and ornithological tourism.",9,0,female_feminine,9,7848
4580,1150558,common_voice_en_26152.mp3,The stranger seemed satisfied with the answer.,9,0,female_feminine,9,2784
4581,1084694,common_voice_en_35120852.mp3,The protest ended without incident.,9,0,female_feminine,9,3564
4582,454580,common_voice_en_60057.mp3,The woman was silent for some time.,9,0,female_feminine,9,3984
4583,999488,common_voice_en_32876871.mp3,The game has been Wastelands Interactive biggest project up to date.,9,0,female_feminine,9,4968
4584,390779,common_voice_en_119366.mp3,They had gone away to breakfast at Henderson's house.,9,0,female_feminine,9,3624
4585,365291,common_voice_en_32759043.mp3,This gave the Templar Order an official sanction as defenders of the Catholic Church.,9,0,female_feminine,9,7200
4586,793885,common_voice_en_37038183.mp3,This region have Godawari river at Nashik.,9,0,female_feminine,9,5544
4587,399500,common_voice_en_9750.mp3,"When you are loved, you can do anything in creation.",12,3,female_feminine,9,4488
4588,407109,common_voice_en_46100.mp3,"The sun thought about that, and decided to shine more brightly.",9,0,female_feminine,9,5088
4589,566821,common_voice_en_53489.mp3,But he didn't need to worry about that right now.,10,1,female_feminine,9,5808
4590,663963,common_voice_en_75800.mp3,"He wanted your money, he said.",9,0,female_feminine,9,2112
4591,220023,common_voice_en_20285928.mp3,It is directed by Craig Henderson.,10,1,female_feminine,9,3912
4592,438109,common_voice_en_57001.mp3,"At once, he connected the two incidents.",9,0,female_feminine,9,3504
4593,819189,common_voice_en_680172.mp3,They set off running wildly into the trees.,9,0,female_feminine,9,4464
4594,371373,common_voice_en_31303679.mp3,It was the second time they had arrested him.,9,0,female_feminine,9,4860
4595,1077730,common_voice_en_31767071.mp3,Miller combined hydrotherapy with diet as complementary therapeutics.,9,0,female_feminine,9,4788
4596,1077731,common_voice_en_31767087.mp3,Both Twitter and official websites also confirm the new series.,9,0,female_feminine,9,4968
4597,1375797,common_voice_en_38354420.mp3,The range lies in a southwest-northeasterly direction between Crescent Valley and Pine Valley.,18,9,female_feminine,9,8856
4598,883862,common_voice_en_33342723.mp3,She majored in English at Fu Jen Catholic University.,9,0,female_feminine,9,5868
4599,711862,common_voice_en_42097.mp3,"The old man was probably a Gypsy, too.",10,1,female_feminine,9,4944
4600,220024,common_voice_en_20285929.mp3,I've done that for the last couple of years.,10,1,female_feminine,9,3456
4601,1192699,common_voice_en_32248899.mp3,Real time three dimensional graphics are used for bosses and terrain.,8,0,female_feminine,8,5688
4602,1192691,common_voice_en_32248891.mp3,Fried.,8,0,female_feminine,8,2520
4603,1192697,common_voice_en_32248897.mp3,The female wasp lays eggs in an aphid.,8,0,female_feminine,8,4680
4604,1192696,common_voice_en_32248896.mp3,Critics of the proposal were quick to ring changes on the term.,8,0,female_feminine,8,5688
4605,1192692,common_voice_en_32248892.mp3,Three of the bedrooms were double rooms and the rest single rooms.,8,0,female_feminine,8,5400
4606,1192693,common_voice_en_32248893.mp3,Fans often request that Swallow write the catchphrase when she signs autographs.,8,0,female_feminine,8,7128
4607,1192694,common_voice_en_32248894.mp3,He was interred at Davison Cemetery.,8,0,female_feminine,8,3996
4608,1192695,common_voice_en_32248895.mp3,They are found in tropical and subtropical waters around the world.,8,0,female_feminine,8,5796
4609,1488827,common_voice_en_38593602.mp3,"According to a leaked diary, he received one vote on the fourth ballot.",10,2,female_feminine,8,5868
4610,1192690,common_voice_en_32248880.mp3,Derin was the last to join the group that summer.,8,0,female_feminine,8,4428
4611,663798,common_voice_en_101092.mp3,It spread through the planet's atmosphere and obscured its more familiar features.,8,0,female_feminine,8,6816
4612,698843,common_voice_en_32639287.mp3,It is traversed by minor public roads and rural lanes.,8,0,female_feminine,8,4680
4613,1192664,common_voice_en_32248763.mp3,She studied French literature.,8,0,female_feminine,8,3996
4614,1192662,common_voice_en_32248761.mp3,He retired with the rank of Commander.,8,0,female_feminine,8,4248
4615,1192661,common_voice_en_32248760.mp3,Zoe crawls through the bathroom ceiling and is able to escape the school.,8,0,female_feminine,8,6156
4616,698842,common_voice_en_32639286.mp3,The quake severely damaged many churches that were predominantly masonry constructed.,8,0,female_feminine,8,6156
4617,1192660,common_voice_en_32248759.mp3,The plot now switches to Adam Gillis and his sister.,8,0,female_feminine,8,5616
4618,1192659,common_voice_en_32248758.mp3,All musics and lyrics are produced by Kazumasa Oda.,8,0,female_feminine,8,5940
4619,1192657,common_voice_en_32248748.mp3,Most people assumed that no girl would want to play.,8,0,female_feminine,8,4896
4620,1192730,common_voice_en_32249272.mp3,It is considered one of if not the most important work by Amos.,8,0,female_feminine,8,6300
4621,1192655,common_voice_en_32248746.mp3,Key players for Jackson State included quarterback Roy Curry and end Willie Richardson.,8,0,female_feminine,8,7596
4622,1192654,common_voice_en_32248745.mp3,The guests never overshadow Eli and his core band but add subtleties and nuances.,8,0,female_feminine,8,8136
4623,1192653,common_voice_en_32248744.mp3,Isaak was born and raised in the United Kingdom.,8,0,female_feminine,8,4860
4624,1192652,common_voice_en_32248743.mp3,Nathan Neely Fleming was elected as Speaker after he departed.,8,0,female_feminine,8,5148
4625,1192651,common_voice_en_32248742.mp3,They tend to be shrubs or small trees.,8,0,female_feminine,8,5076
4626,1192682,common_voice_en_32248865.mp3,Most of these Kurds were from the Yezidi minority.,8,0,female_feminine,8,4860
4627,1661892,common_voice_en_37991376.mp3,The driving force is the formation of the gas carbon dioxide.,8,0,female_feminine,8,5760
4628,1192650,common_voice_en_32248741.mp3,"He later worked on ""Doctor Kildare"" as an associate producer.",8,0,female_feminine,8,5688
4629,1192649,common_voice_en_32248740.mp3,All stations are within Fukuoka Prefecture.,8,0,female_feminine,8,5796
4630,1192647,common_voice_en_32248738.mp3,The forests on much of Babeldaob have been cleared and replaced with grassland.,8,0,female_feminine,8,6768
4631,1192656,common_voice_en_32248747.mp3,He left country music and began performing Southern gospel music.,8,0,female_feminine,8,5940
4632,1192689,common_voice_en_32248879.mp3,Chechen by nationality.,8,0,female_feminine,8,3420
4633,698845,common_voice_en_32639290.mp3,He then worked at the Polish consul of maritime affairs in New York City.,8,0,female_feminine,8,5436
4634,1192688,common_voice_en_32248877.mp3,The plant is owned and developed by Mandu Hydropower Pvt.,8,0,female_feminine,8,5796
4635,1192687,common_voice_en_32248876.mp3,Another concern of his was adult education.,8,0,female_feminine,8,4608
4636,1192685,common_voice_en_32248868.mp3,He later studied at New College at the University of Oxford.,8,0,female_feminine,8,5580
4637,1192683,common_voice_en_32248866.mp3,King went on to start Protection Plus Security Limited.,8,0,female_feminine,8,4968
4638,1192714,common_voice_en_32248915.mp3,No civilian awards were made.,8,0,female_feminine,8,3996
4639,1192681,common_voice_en_32248864.mp3,He finds Mark Rees (Kiefer Moriarty) about to assault Ruhma.,8,0,female_feminine,8,6408
4640,1192679,common_voice_en_32248862.mp3,He replaced Aleksei Sorokin.,8,0,female_feminine,8,3636
4641,1192665,common_voice_en_32248764.mp3,The other two schools were paid for with money from the prefectural budget.,8,0,female_feminine,8,5616
4642,1192676,common_voice_en_32248849.mp3,Further competition successes and commissions followed.,8,0,female_feminine,8,5328
4643,1192675,common_voice_en_32248848.mp3,The proposals were challenged in judicial review.,8,0,female_feminine,8,4356
4644,1192674,common_voice_en_32248847.mp3,The church was designed by William Henry Hill.,8,0,female_feminine,8,4608
4645,1192673,common_voice_en_32248846.mp3,Conferences can also be hosted at this location.,8,0,female_feminine,8,4860
4646,1192672,common_voice_en_32248771.mp3,Shchigorevka is the nearest rural locality.,8,0,female_feminine,8,5076
4647,698844,common_voice_en_32639289.mp3,She also performed with her successors at Alibi Bookshop.,8,0,female_feminine,8,4788
4648,1192670,common_voice_en_32248769.mp3,It rises across the piazza from the church of the Addolorata.,8,0,female_feminine,8,6048
4649,1192668,common_voice_en_32248767.mp3,It has also been known as the Pythian Temple.,8,0,female_feminine,8,4248
4650,1192667,common_voice_en_32248766.mp3,He came over from Denmark to Southern California.,8,0,female_feminine,8,4716
4651,1192698,common_voice_en_32248898.mp3,They were quickly recaptured.,8,0,female_feminine,8,3888
4652,1192678,common_voice_en_32248861.mp3,It was designed to be compatible with existing launch and ground support equipment.,8,0,female_feminine,8,6408
4653,1192760,common_voice_en_32249342.mp3,Her kitchen work triangle design is still in use.,8,0,female_feminine,8,4680
4654,1192759,common_voice_en_32249341.mp3,It was released with the official music video.,8,0,female_feminine,8,4140
4655,1192758,common_voice_en_32249320.mp3,Gerri takes over for Frank in giving speeches to the shareholders.,8,0,female_feminine,8,5436
4656,437968,common_voice_en_31920663.mp3,Ambassador is Minh Vu Nguyen.,8,0,female_feminine,8,3528
4657,1192757,common_voice_en_32249319.mp3,The mouse eats seeds and invertebrates such as earthworms.,8,0,female_feminine,8,5400
4658,1192755,common_voice_en_32249317.mp3,Simeon in the scene recognizes the infant as the future redeemer.,8,0,female_feminine,8,6048
4659,698848,common_voice_en_32639312.mp3,It is because they would not show hospitality to wayfarers.,8,0,female_feminine,8,4716
4660,1192754,common_voice_en_32249316.mp3,The casualties of the Farmer circuit were heavy.,8,0,female_feminine,8,4248
4661,1192753,common_voice_en_32249310.mp3,The parish rests alongside the county border with Lincolnshire.,8,0,female_feminine,8,5580
4662,1192648,common_voice_en_32248739.mp3,He wrapped her in light and dropped her down through the hole.,8,0,female_feminine,8,4896
4663,1192749,common_voice_en_32249306.mp3,Three main classes of recreational diving tourism destinations exist.,8,0,female_feminine,8,6516
4664,1114149,common_voice_en_27467987.mp3,The village is a popular residential area.,8,0,female_feminine,8,3852
4665,1192748,common_voice_en_32249305.mp3,He honored his mother as Empress Dowager.,8,0,female_feminine,8,4428
4666,1192747,common_voice_en_32249304.mp3,He was not elected as his party won one seat.,8,0,female_feminine,8,5220
4667,1192778,common_voice_en_32249380.mp3,The split did not divide any of the resident families.,8,0,female_feminine,8,4968
4668,1192745,common_voice_en_32249302.mp3,She began writing poetry at an early age.,8,0,female_feminine,8,4680
4669,1192743,common_voice_en_32249290.mp3,Arlan is the nearest rural locality.,8,0,female_feminine,8,4248
4670,1192742,common_voice_en_32249289.mp3,"Wang ""et al"".",8,0,female_feminine,8,3168
4671,1192741,common_voice_en_32249288.mp3,"The association organizes ""Yangon Dental Festival"" every year.",8,0,female_feminine,8,6048
4672,1192751,common_voice_en_32249308.mp3,It is the basketball section of the University of Zambia.,8,0,female_feminine,8,4968
4673,1192779,common_voice_en_32249396.mp3,Depictions of the monument have been used by the university in various occasions.,8,0,female_feminine,8,6120
4674,682942,common_voice_en_44615.mp3,"The heather was on fire, and you could see a thin blue smoke rising up slowly.",8,0,female_feminine,8,6024
4675,698819,common_voice_en_32639108.mp3,Mass production were planned but setbacks caused it to never happened.,8,0,female_feminine,8,8028
4676,659581,common_voice_en_32699418.mp3,The store is located in red brick buildings dating to before the Civil War.,8,0,female_feminine,8,6228
4677,698818,common_voice_en_32639047.mp3,There are two entrances into the parking bay.,8,0,female_feminine,8,4608
4678,266231,common_voice_en_12825.mp3,"Sadly, my dream of becoming a squirrel whisperer may never happen.",8,0,female_feminine,8,6528
4679,1192777,common_voice_en_32249379.mp3,It is known for its high and beautiful surrounding.,8,0,female_feminine,8,4968
4680,1192776,common_voice_en_32249378.mp3,He was member of the Club of Catholic Intelligentsia.,8,0,female_feminine,8,5076
4681,1192775,common_voice_en_32249377.mp3,He also published several books.,8,0,female_feminine,8,3780
4682,1192761,common_voice_en_32249343.mp3,The main two harvests the villagers gather are carrots and potatoes.,8,0,female_feminine,8,5616
4683,1192773,common_voice_en_32249375.mp3,She luckily succeeded avoiding deportation to Germany.,8,0,female_feminine,8,4716
4684,682976,common_voice_en_44649.mp3,And then he perceived it very slowly.,8,0,female_feminine,8,3816
4685,1192771,common_voice_en_32249373.mp3,It’s misappropriation or manipulation.,8,0,female_feminine,8,4320
4686,1192770,common_voice_en_32249372.mp3,She served only one term as parliamentarian.,8,0,female_feminine,8,4860
4687,1192769,common_voice_en_32249371.mp3,He then moved to play for Newcastle Northern.,8,0,female_feminine,8,4176
4688,1192768,common_voice_en_32249360.mp3,Graffiti tributes of the murdered rapper appear throughout the video.,8,0,female_feminine,8,5220
4689,682977,common_voice_en_44650.mp3,The only shadow was that of the few scattered pine trees.,8,0,female_feminine,8,6024
4690,1192764,common_voice_en_32249356.mp3,Since then the species was not recorded from the country.,8,0,female_feminine,8,4896
4691,1478905,common_voice_en_34926240.mp3,The pool is located parallel to the football field.,8,0,female_feminine,8,4140
4692,1192774,common_voice_en_32249376.mp3,He also reads and understands Spanish.,8,0,female_feminine,8,3780
4693,1192718,common_voice_en_32248919.mp3,Robbins was born and raised in Bermuda.,8,0,female_feminine,8,4248
4694,1192717,common_voice_en_32248918.mp3,Book is the granddaughter of sharecroppers from Louisiana.,8,0,female_feminine,8,5400
4695,1192716,common_voice_en_32248917.mp3,He nevertheless remained active in local politics after his retirement.,8,0,female_feminine,8,5940
4696,1192715,common_voice_en_32248916.mp3,The Orange were led by thirteenth year head coach Quentin Hillsman.,8,0,female_feminine,8,6048
4697,1192746,common_voice_en_32249303.mp3,She became the first amateur in Taiwan to capture three wins.,8,0,female_feminine,8,5796
4698,637841,common_voice_en_62503.mp3,"In spite of this, I still believed that there were men in Mars.",8,0,female_feminine,8,3984
4699,1192713,common_voice_en_32248914.mp3,They had been waiting at Line Barracks (Police Headquarters) for their pay.,8,0,female_feminine,8,5868
4700,1192711,common_voice_en_32248912.mp3,The Earl of Mar was absent.,8,0,female_feminine,8,3636
4701,611325,common_voice_en_186346.mp3,Some storms are worth the wreckage.,8,0,female_feminine,8,3648
4702,682979,common_voice_en_44652.mp3,The loafers and golf caddies were used to hanging out near the railway station.,8,0,female_feminine,8,5472
4703,1192709,common_voice_en_32248910.mp3,He was the owner of the manor of Beeston and Beeston Castle.,8,0,female_feminine,8,5148
4704,1192708,common_voice_en_32248909.mp3,He was also known as the Duke of Tacoma.,8,0,female_feminine,8,4140
4705,1192707,common_voice_en_32248908.mp3,The literature conflicts on when command was passed from one to the other.,8,0,female_feminine,8,5328
4706,1192706,common_voice_en_32248906.mp3,"He then worked for the magazines ""El Viejo Topo"" and ""El Papus"".",8,0,female_feminine,8,7488
4707,956131,common_voice_en_31252208.mp3,Original character designs are provided by Oh!,10,2,female_feminine,8,3168
4708,1192703,common_voice_en_32248903.mp3,He divides his time between Westminster and Cardiff Bay.,8,0,female_feminine,8,5616
4709,1192702,common_voice_en_32248902.mp3,She won the bout via split decision.,8,0,female_feminine,8,3888
4710,659582,common_voice_en_32699489.mp3,He has also played some Asian and Australian senior events.,8,0,female_feminine,8,5292
4711,1192700,common_voice_en_32248900.mp3,He went to Brooklyn College.,8,0,female_feminine,8,3420
4712,1192710,common_voice_en_32248911.mp3,It is propelled by both sail and oars.,8,0,female_feminine,8,4248
4713,1192740,common_voice_en_32249287.mp3,Tracy also served on the Fletcher Allen Health Care board of trustees.,8,0,female_feminine,8,6120
4714,1192739,common_voice_en_32249286.mp3,The marriage ended some years later.,8,0,female_feminine,8,4176
4715,1192738,common_voice_en_32249280.mp3,The region is surrounded inland by the Yucatan dry forests ecoregion.,8,0,female_feminine,8,5868
4716,1192737,common_voice_en_32249279.mp3,He is an Associate Judge on the Superior Court of the District of Columbia.,8,0,female_feminine,8,5580
4717,1192736,common_voice_en_32249278.mp3,"The Roses adapted ""Brant"" for use as an oil exploration survey vessel.",8,0,female_feminine,8,6336
4718,1192735,common_voice_en_32249277.mp3,This fjord is the innermost tributary of Kaiser Franz Joseph Fjord.,8,0,female_feminine,8,6660
4719,1544376,common_voice_en_31920430.mp3,Nemi and he fell in love and were married.,8,0,female_feminine,8,4356
4720,1192733,common_voice_en_32249275.mp3,Shearer played at the forward position.,8,0,female_feminine,8,3996
4721,1192731,common_voice_en_32249273.mp3,She was food service director to Michigan State University.,8,0,female_feminine,8,5616
4722,1192721,common_voice_en_32248922.mp3,He was also Chairman of the Laird Group.,8,0,female_feminine,8,3780
4723,698846,common_voice_en_32639308.mp3,Penn finished third in the Ivy League.,8,0,female_feminine,8,3168
4724,454603,common_voice_en_60080.mp3,"So he began to wander through the city, and found himself at the gates.",8,0,female_feminine,8,5064
4725,1192729,common_voice_en_32248930.mp3,The kitchen remains and the laundry has been converted to toilets.,8,0,female_feminine,8,5328
4726,637840,common_voice_en_62502.mp3,"When I returned to the common, the sun was setting.",9,1,female_feminine,8,3240
4727,1192727,common_voice_en_32248928.mp3,North Dakota state officials appointed their replacements.,8,0,female_feminine,8,4896
4728,1192726,common_voice_en_32248927.mp3,In December it produces linear shaped seed pods that are raised over the seeds.,8,0,female_feminine,8,6768
4729,1192725,common_voice_en_32248926.mp3,It typically inhabits wetlands and other moist habitats.,8,0,female_feminine,8,5076
4730,1192724,common_voice_en_32248925.mp3,The game was developed and published by the independent studio Atom Team.,8,0,female_feminine,8,5796
4731,1192723,common_voice_en_32248924.mp3,It has two screens (on both sides of the phone) which can operate independently.,8,0,female_feminine,8,6048
4732,1192722,common_voice_en_32248923.mp3,It is not known what Lazier was doing in the monastery.,8,0,female_feminine,8,4680
4733,1192762,common_voice_en_32249344.mp3,The Big Ballot was sponsored by Bonkers fruit chews and Post Cereal.,8,0,female_feminine,8,6048
4734,1150642,common_voice_en_26236.mp3,The burning fire had been extinguished.,8,0,female_feminine,8,2520
4735,698814,common_voice_en_32639043.mp3,The climate is moderate continental with cold winters and warm summers.,8,0,female_feminine,8,6768
4736,698813,common_voice_en_32639007.mp3,The board decided to dissolve the district.,8,0,female_feminine,8,5076
4737,698812,common_voice_en_32639006.mp3,It was said that only their children and religion kept them together.,8,0,female_feminine,8,5976
4738,1660858,common_voice_en_37970749.mp3,"This caused her to be fired, so she started performing elsewhere.",8,0,female_feminine,8,5760
4739,1522525,common_voice_en_36906334.mp3,The throwing it into a stream is most probably a rain-charm.,8,0,female_feminine,8,3744
4740,1672015,common_voice_en_20286286.mp3,"The first performance of ""The Mandarin's Son"" was ""domestic,"" so to speak.",8,0,female_feminine,8,5304
4741,1672014,common_voice_en_20286282.mp3,"She now has her own blog, Diane Ravitch's Blog.",8,0,female_feminine,8,5424
4742,1192780,common_voice_en_32249397.mp3,The Raiders returned home to face the Dolphins in Week Three.,8,0,female_feminine,8,4896
4743,1150678,common_voice_en_26272.mp3,"Gypsies are experts at getting people to do that, sighed the old man.",8,0,female_feminine,8,4032
4744,293333,common_voice_en_37484505.mp3,"Parker was the son of Thomas Watson Parker of Lewisham, Kent, England.",8,0,female_feminine,8,9288
4745,698809,common_voice_en_32639003.mp3,Then an exhibition and conference centre in Paris.,8,0,female_feminine,8,4788
4746,1150680,common_voice_en_26274.mp3,"At that point, the omens will tell you that your treasure is buried forever.",8,0,female_feminine,8,4392
4747,1479026,common_voice_en_34931415.mp3,"The people's reaction, however, plants the seed of doubt inside Chantal.",8,0,female_feminine,8,5400
4748,293336,common_voice_en_37484510.mp3,Earlier reports had claimed that the name would have been Simeon Francisco Javier.,8,0,female_feminine,8,9576
4749,1525115,common_voice_en_37016441.mp3,"On his retirement, Martel wrote on military matters.",8,0,female_feminine,8,3960
4750,1150683,common_voice_en_26277.mp3,The caravan began to travel day and night.,8,0,female_feminine,8,2712
4751,698811,common_voice_en_32639005.mp3,The copper is located in three paralleling veins within the basin.,8,0,female_feminine,8,6408
4752,437985,common_voice_en_31920926.mp3,The track was played via video conference between the musicians.,8,0,female_feminine,8,5544
4753,1522407,common_voice_en_36885312.mp3,It is owned by Nassau County and serves large portions of the county.,8,0,female_feminine,8,4824
4754,1671998,common_voice_en_20286147.mp3,The Bally Astrocade is a second generation console created by Bally.,8,0,female_feminine,8,6624
4755,663828,common_voice_en_101122.mp3,Henderson went into the railway station to telegraph the news to London.,8,0,female_feminine,8,5544
4756,1249084,common_voice_en_29581195.mp3,Each handle is approximately eight inches long.,8,0,female_feminine,8,4140
4757,437986,common_voice_en_31920928.mp3,He owned and operated the Jude Candy and Tobacco Company.,8,0,female_feminine,8,5904
4758,437988,common_voice_en_31921085.mp3,Most of them are found in the Sibiu County.,8,0,female_feminine,8,3600
4759,1659956,common_voice_en_37957537.mp3,"“Come on!” cried his guide, with terror in his voice.",8,0,female_feminine,8,5976
4760,438098,common_voice_en_56990.mp3,My tax dollars pay for those public school proms.,8,0,female_feminine,8,4104
4761,1672005,common_voice_en_20286205.mp3,Taiwan uses two crossbucks.,8,0,female_feminine,8,4680
4762,1672004,common_voice_en_20286204.mp3,This exhibits the same principle without the maths.,8,0,female_feminine,8,4824
4763,567302,common_voice_en_83162.mp3,The two men hurried back and found the cylinder still lying in the same position.,8,0,female_feminine,8,5016
4764,1150668,common_voice_en_26262.mp3,The boy awoke before dawn.,8,0,female_feminine,8,2616
4765,418622,common_voice_en_59117.mp3,I SHALL MAKE US SOME ICE CUBES.,9,1,female_feminine,8,3336
4766,418633,common_voice_en_59129.mp3,Something inside the cylinder was unscrewing the top.,8,0,female_feminine,8,2736
4767,437990,common_voice_en_31921088.mp3,At this point Thomson and Blake were aligned in nationalist politics.,8,0,female_feminine,8,5760
4768,293331,common_voice_en_37484503.mp3,He is based in Bilbao.,8,0,female_feminine,8,3528
4769,293332,common_voice_en_37484504.mp3,The media was aware of this fact but cooperated in keeping it secret.,8,0,female_feminine,8,6840
4770,437989,common_voice_en_31921086.mp3,His nephew is actor and model Johann Urb.,8,0,female_feminine,8,4752
4771,1189167,common_voice_en_32912984.mp3,He was only the second priest to endeavor to do so.,8,0,female_feminine,8,4608
4772,1386847,common_voice_en_38690740.mp3,"Honda's production lines of these models were in Spain, Belgium and Sweden.",10,2,female_feminine,8,10188
4773,538868,common_voice_en_59368.mp3,You can't believe it's not butter?,9,1,female_feminine,8,2688
4774,538872,common_voice_en_59372.mp3,I just don't trust anyone who says they've never had Hamburger Helper.,8,0,female_feminine,8,4776
4775,220029,common_voice_en_20285955.mp3,They passionately kiss as the room begins to flood and the storm rages outside.,8,0,female_feminine,8,5952
4776,288747,common_voice_en_900.mp3,"The falcon's beak carries bits of me, myself, the desert said.",12,4,female_feminine,8,10464
4777,894818,common_voice_en_536260.mp3,The thought was so dreadful to him that he forgot about the heat and went forward.,8,0,female_feminine,8,5304
4778,711804,common_voice_en_42039.mp3,The boy's heart began to speak of fear.,8,0,female_feminine,8,4536
4779,706096,common_voice_en_18012934.mp3,"If you add another two storeys, you'll need more support pillars.",8,0,female_feminine,8,5976
4780,538851,common_voice_en_573392.mp3,Henderson went into the railway station to telegraph the news to London.,8,0,female_feminine,8,5544
4781,1189239,common_voice_en_33271633.mp3,Sports and association football in particular were and are indispensable in Mannheim.,8,0,female_feminine,8,7416
4782,894826,common_voice_en_536268.mp3,They set off running wildly into the trees.,9,1,female_feminine,8,3168
4783,1524963,common_voice_en_30645896.mp3,His few friends said that he was born for his exalted and unsalaried post.,8,0,female_feminine,8,4608
4784,1661653,common_voice_en_37987991.mp3,The film is set between the first two movies.,10,2,female_feminine,8,4716
4785,742679,common_voice_en_693910.mp3,"Down below in the darkness were hundreds of people, sleeping in peace.",8,0,female_feminine,8,5496
4786,513007,common_voice_en_35432768.mp3,Markets are held here twice per week.,8,0,female_feminine,8,4248
4787,711817,common_voice_en_42052.mp3,He was already re- accustomed to desert's silence.,8,0,female_feminine,8,7704
4788,1479997,common_voice_en_35341691.mp3,"Once out of the fig, the male wasps quickly die.",8,0,female_feminine,8,4320
4789,1543815,common_voice_en_31865377.mp3,Once you’re known for doing something good you have to continue doing good things.,8,0,female_feminine,8,5508
4790,1115833,common_voice_en_30704860.mp3,Several additions were made to the structure in the following years.,8,0,female_feminine,8,5472
4791,420194,common_voice_en_144136.mp3,"My seven year resume gap is marked ""Not Drugs"".",8,0,female_feminine,8,4944
4792,630705,common_voice_en_48184.mp3,"When I had my sheep, I was happy, and I made those around me happy.",10,2,female_feminine,8,5136
4793,1478541,common_voice_en_34915320.mp3,"During this period, ""Silicon Ice Development"" changed its name to ""FrozenSand"".",8,0,female_feminine,8,6372
4794,711812,common_voice_en_42047.mp3,"I know good crystal from bad, and everything else there is to know about crystal.",8,0,female_feminine,8,6096
4795,1672017,common_voice_en_20286292.mp3,Admiral Pierre Lacoste made a statement saying Pereira's death weighed heavily on his conscience.,8,0,female_feminine,8,7224
4796,1479998,common_voice_en_35341712.mp3,The community interest company is intended to meet this need.,8,0,female_feminine,8,4464
4797,1522265,common_voice_en_36851603.mp3,He is a Professor of Mathematics at the Hebrew University of Jerusalem.,8,0,female_feminine,8,5400
4798,1189246,common_voice_en_33271645.mp3,Seeing Martin Luther as the destroyer of the Christian faith.,8,0,female_feminine,8,5616
4799,1524988,common_voice_en_30645921.mp3,The original architecture resembled that of Louisiana and South Carolina.,8,0,female_feminine,8,4968
4800,216011,common_voice_en_53438.mp3,"Coming home, a party of tourists passed us, singing and playing music.",8,0,female_feminine,8,5136
4801,1150672,common_voice_en_26266.mp3,He took out one of the stones.,9,1,female_feminine,8,2088
4802,630707,common_voice_en_48186.mp3,"During one of these conversations, the driver told of his own life.",8,0,female_feminine,8,5760
4803,711821,common_voice_en_42056.mp3,"That night, there was another jetting out of gas from the distant planet.",8,0,female_feminine,8,6480
4804,437979,common_voice_en_31920848.mp3,Beebe had taught him how to distinguish tones and how to respond to them.,8,0,female_feminine,8,6192
4805,437980,common_voice_en_31920849.mp3,A tractor operator died in an incident later the same month.,8,0,female_feminine,8,4536
4806,1189114,common_voice_en_32695754.mp3,Ashraf brings them into the police station.,8,0,female_feminine,8,4500
4807,437981,common_voice_en_31920850.mp3,Raman resides in the Silver Lake neighborhood of Los Angeles.,8,0,female_feminine,8,5112
4808,220025,common_voice_en_20285930.mp3,"Dinner would be a meat dish, often accompanied by potatoes or other vegetable curry.",9,1,female_feminine,8,6576
4809,1488752,common_voice_en_38512926.mp3,The signs were removed at that time.,10,2,female_feminine,8,3600
4810,698826,common_voice_en_32639126.mp3,"Her ""small and shapely"" hands and feet were also measured and admired.",8,0,female_feminine,8,5436
4811,1521254,common_voice_en_36612903.mp3,It's an inspirational and professional tool that can bring life into focus.,10,2,female_feminine,8,4392
4812,1658871,common_voice_en_37936212.mp3,There are no bars.,8,0,female_feminine,8,2736
4813,605330,common_voice_en_31439653.mp3,Alexander St.,8,0,female_feminine,8,2916
4814,408149,common_voice_en_595100.mp3,My tax dollars pay for those public school proms.,8,0,female_feminine,8,3216
4815,698825,common_voice_en_32639125.mp3,The engine room flooded and the engines stopped.,8,0,female_feminine,8,3816
4816,1532000,common_voice_en_32375063.mp3,This is an authentic drama that will bypass all film festivals.,8,0,female_feminine,8,5256
4817,437983,common_voice_en_31920852.mp3,She then sailed primarily between London and Demerara.,8,0,female_feminine,8,6336
4818,566856,common_voice_en_53525.mp3,"If good things are coming, they will be a pleasant surprise, said the seer.",8,0,female_feminine,8,6696
4819,714903,common_voice_en_178402.mp3,It seemed so safe and tranquil.,8,0,female_feminine,8,4224
4820,698824,common_voice_en_32639124.mp3,He heard news of the recent Scottish diplomatic mission to Denmark.,8,0,female_feminine,8,4968
4821,698823,common_voice_en_32639112.mp3,The spider is found from northern to central western Madagascar.,8,0,female_feminine,8,5976
4822,698822,common_voice_en_32639111.mp3,These papers were highlighted in an independent editorial.,8,0,female_feminine,8,5400
4823,826813,common_voice_en_83682.mp3,I just don't trust anyone who says they've never had Hamburger Helper.,8,0,female_feminine,8,3864
4824,951023,common_voice_en_30498288.mp3,The sand pit was operated by him and his family for many years.,8,0,female_feminine,8,3960
4825,1150581,common_voice_en_26175.mp3,"There are powerful forces on both sides, and the war is important to both armies.",8,0,female_feminine,8,4464
4826,1522052,common_voice_en_36842479.mp3,Most reforestation is in pines.,8,0,female_feminine,8,3132
4827,1192646,common_voice_en_32248737.mp3,Environmental impact assessment of these works was not carried out.,8,0,female_feminine,8,6120
4828,1192645,common_voice_en_32248735.mp3,It is in the community of Houghton Lake Heights within Roscommon Township.,8,0,female_feminine,8,6588
4829,1192666,common_voice_en_32248765.mp3,He was eventually brought back to Kronstadt with the survivors of the evacuation force.,8,0,female_feminine,8,6300
4830,1150586,common_voice_en_26180.mp3,He spent the entire morning observing the infrequent comings and goings in the street.,8,0,female_feminine,8,4440
4831,477129,common_voice_en_31767456.mp3,Ivrea hosted the event for the first time.,8,0,female_feminine,8,5328
4832,698841,common_voice_en_32639213.mp3,Many people call this day the beginning of the goddess.,8,0,female_feminine,8,3636
4833,1530365,common_voice_en_32255983.mp3,Less formally she spoke in mission halls.,8,0,female_feminine,8,3168
4834,698840,common_voice_en_32639212.mp3,He tends to be known locally for his eccentric personality.,8,0,female_feminine,8,4140
4835,663780,common_voice_en_101074.mp3,The newspaper articles had prepared everyone for the reception of the idea.,8,0,female_feminine,8,6456
4836,957113,common_voice_en_33010164.mp3,These eruptions have taken place from the main caldera and fissures along rift zones.,8,0,female_feminine,8,8028
4837,1277877,common_voice_en_38125045.mp3,The blue-and-gold Chicago Card Plus was an account-based card.,10,2,female_feminine,8,4248
4838,698838,common_voice_en_32639210.mp3,She was encouraged by her mother to study.,8,0,female_feminine,8,3420
4839,698837,common_voice_en_32639209.mp3,The World Premium is the high definition.,8,0,female_feminine,8,3456
4840,1150566,common_voice_en_26160.mp3,Melchizedek watched a small ship that was plowing its way out of the port.,8,0,female_feminine,8,4152
4841,1522449,common_voice_en_36885457.mp3,It is situated on the south side of the airfield.,8,0,female_feminine,8,3924
4842,698830,common_voice_en_32639141.mp3,In some places the channels are less than wide and deep.,8,0,female_feminine,8,3888
4843,698829,common_voice_en_32639140.mp3,It also offers videos that present hatchery operations.,8,0,female_feminine,8,4680
4844,698827,common_voice_en_32639127.mp3,The railing was made of sandstone.,8,0,female_feminine,8,3276
4845,698839,common_voice_en_32639211.mp3,He was part of the original cast since the show began.,8,0,female_feminine,8,4140
4846,84581,common_voice_en_30770666.mp3,Park is married with one child.,8,0,female_feminine,8,3096
4847,84580,common_voice_en_30770664.mp3,Educated at the Imperial Konstantinovsky land surveying institute.,8,0,female_feminine,8,5148
4848,659597,common_voice_en_33495771.mp3,Such equation is seen as possible by Aidan Dodson and Dyan Hilton.,8,0,female_feminine,8,5760
4849,84579,common_voice_en_30770663.mp3,Nickerson also personally delivered the document to three members of the Alabama congressional delegation.,8,0,female_feminine,8,8028
4850,437973,common_voice_en_31920711.mp3,Its investment paid off and the team returned from each successive event with medals.,8,0,female_feminine,8,6444
4851,437977,common_voice_en_31920824.mp3,It was acquired that year from Donoughmore Church by the art collector Andrew Fountaine.,8,0,female_feminine,8,7560
4852,698816,common_voice_en_32639045.mp3,He has performed in cities and towns across Ireland.,8,0,female_feminine,8,5400
4853,1061419,common_voice_en_39198258.mp3,He changes the metric of power based on the point in time.,14,6,female_feminine,8,3780
4854,92188,common_voice_en_36528132.mp3,"Rarer sightings may include bobcats, coyotes, wolves, and the occasional moose.",8,0,female_feminine,8,7020
4855,1067107,common_voice_en_34943619.mp3,He was one of the main facilitators for the demand of the university.,8,0,female_feminine,8,5760
4856,293338,common_voice_en_37484516.mp3,In Menden there are many sport clubs.,8,0,female_feminine,8,3708
4857,293337,common_voice_en_37484511.mp3,"He was cremated with his ashes interred at Northern Suburbs Memorial Gardens, North Ryde.",8,0,female_feminine,8,8640
4858,1150652,common_voice_en_26246.mp3,"If I had told you, you wouldn't have seen the Pyramids.",8,0,female_feminine,8,3288
4859,437982,common_voice_en_31920851.mp3,And I’m glad we did.,8,0,female_feminine,8,3276
4860,698815,common_voice_en_32639044.mp3,The episode then shows the adventures Susan imagines.,8,0,female_feminine,8,5580
4861,1522108,common_voice_en_36842634.mp3,The church was part of the presbytery of Kirkcaldy.,8,0,female_feminine,8,3708
4862,1537181,common_voice_en_27186477.mp3,I am dangerously stupid.,13,5,female_feminine,8,2808
4863,1671986,common_voice_en_20286045.mp3,Thomas Betterton made his stage debut in the title role.,9,1,female_feminine,8,6024
4864,293340,common_voice_en_37488889.mp3,He spent much of his younger life in Europe.,8,0,female_feminine,8,4428
4865,698821,common_voice_en_32639110.mp3,The series was filmed in Manchester.,8,0,female_feminine,8,4140
4866,92186,common_voice_en_36528130.mp3,"Kupperberg created the ""Takion"" series as well.",8,0,female_feminine,8,4500
4867,921846,common_voice_en_38990870.mp3,"Doctor Fox began his academic career at Lebanon Valley College in Annville, Pennsylvania.",8,0,female_feminine,8,8820
4868,1150614,common_voice_en_26208.mp3,"If you pay attention to the present, you can improve upon it.",8,0,female_feminine,8,3816
4869,1371432,common_voice_en_38099268.mp3,The road is single carriageway ordinary road almost all of it.,10,2,female_feminine,8,5796
4870,1150620,common_voice_en_26214.mp3,He approached the mass and was surprised at the size and the shape.,8,0,female_feminine,8,3720
4871,1545100,common_voice_en_31937116.mp3,It is an erect shrub which flowers in late summer (December to April).,8,0,female_feminine,8,5256
4872,969135,common_voice_en_32857506.mp3,Trade relations with Mongolia are recent.,8,0,female_feminine,8,5004
4873,1489803,common_voice_en_38796514.mp3,"College teams wearing the helmet include Air Force, Penn State, and Virginia.",8,0,female_feminine,8,6300
4874,574990,common_voice_en_18236924.mp3,"Technically, breaking a mirror is not five years, but seven years of bad luck.",9,1,female_feminine,8,8016
4875,1489421,common_voice_en_38744145.mp3,There are four known bishops from antiquity.,10,2,female_feminine,8,4536
4876,1150596,common_voice_en_26190.mp3,"The old man gave a signal, and everyone stood.",8,0,female_feminine,8,3384
4877,1150632,common_voice_en_26226.mp3,"If he ever decided to leave them, they would suffer.",8,0,female_feminine,8,3048
4878,658653,common_voice_en_696274.mp3,"At most, they thought that another meteorite had descended.",8,0,female_feminine,8,5064
4879,437971,common_voice_en_31920709.mp3,He was born near Lake Superior.,8,0,female_feminine,8,3708
4880,1067267,common_voice_en_34971230.mp3,The area of Barnsbury was predominantly rural until the early nineteenth century.,8,0,female_feminine,8,7236
4881,711841,common_voice_en_42076.mp3,"I still have no idea how to turn myself into the wind, the boy repeated.",8,0,female_feminine,8,6504
4882,437972,common_voice_en_31920710.mp3,It was also known as Outlaw Justice.,8,0,female_feminine,8,4104
4883,1544677,common_voice_en_31924844.mp3,"The use of the word ""terrorist"" on his tombstone appears to be meant ironically.",8,0,female_feminine,8,6408
4884,375886,common_voice_en_37634.mp3,I'm never more aware of a room's acoustics than when I'm trying to enjoy a snack I have no intention of sharing.,8,0,female_feminine,8,9048
4885,212405,common_voice_en_93677.mp3,"The battles may last for a long time, perhaps even years.",8,0,female_feminine,8,3888
4886,875571,common_voice_en_35064115.mp3,The village lies on the edge of The Broads National Park.,8,0,female_feminine,8,3636
4887,875570,common_voice_en_35064114.mp3,"Therefore, the first byte is always encoded by its own value.",8,0,female_feminine,8,4356
4888,659602,common_voice_en_33495787.mp3,He attended (National School for Applied Arts Amsterdam) and the Rijksakademie van beeldende kunsten.,8,0,female_feminine,8,7380
4889,1663309,common_voice_en_38017890.mp3,Reactions to his appointment were mixed.,12,4,female_feminine,8,4716
4890,698835,common_voice_en_32639175.mp3,A stream flows through the park.,8,0,female_feminine,8,2808
4891,875567,common_voice_en_35064085.mp3,"Soon after, he becomes the primary source for the new Star Fox's missions.",8,0,female_feminine,8,5580
4892,659603,common_voice_en_33495788.mp3,The effects of this period of history on the Montagnard people was profound.,8,0,female_feminine,8,5616
4893,875566,common_voice_en_35064083.mp3,He died in Port-Marly.,8,0,female_feminine,8,2880
4894,1192973,common_voice_en_32260097.mp3,He taught in Damascus and Aleppo.,8,0,female_feminine,8,3168
4895,875547,common_voice_en_30668243.mp3,Roland has followed her underground and now declares his love for her.,8,0,female_feminine,8,5112
4896,875546,common_voice_en_30668242.mp3,He was the former Maharashtra State Vice President of the Samajwadi Party.,8,0,female_feminine,8,6732
4897,1150515,common_voice_en_26109.mp3,vibrations of peace throughout the tent.,8,0,female_feminine,8,2976
4898,1529965,common_voice_en_32115510.mp3,Their blog contains general computer security advice and also specifically for Windows and phishing.,8,0,female_feminine,8,6696
4899,875545,common_voice_en_30668241.mp3,His mother is an artist and his father an inn keeper.,8,0,female_feminine,8,4608
4900,875544,common_voice_en_30616353.mp3,The greeting is interrupted by the sound of guns when Poro attacks.,8,0,female_feminine,8,4536
4901,875543,common_voice_en_30616341.mp3,The district is primarily residential and includes the oldest portions of the neighborhood.,8,0,female_feminine,8,5436
4902,1150522,common_voice_en_26116.mp3,"I'll work for you, he said.",8,0,female_feminine,8,2160
4903,1387180,common_voice_en_38712300.mp3,Preserved in a public park in Cambrils near Salou.,8,0,female_feminine,8,5076
4904,659604,common_voice_en_33495789.mp3,But it has better maneuverability and can achieve that level of stealth.,8,0,female_feminine,8,5328
4905,637819,common_voice_en_62481.mp3,"There were raised voices,and some sort of struggle appeared to be going on. .",8,0,female_feminine,8,5376
4906,875549,common_voice_en_30668245.mp3,Of his family and private life very little is known.,8,0,female_feminine,8,4500
4907,659596,common_voice_en_32825614.mp3,He operated as chairman of the board for the rest of his life.,8,0,female_feminine,8,4680
4908,394412,common_voice_en_18833.mp3,It must have fallen while I was sitting over there.,8,0,female_feminine,8,6216
4909,1521512,common_voice_en_36633270.mp3,Eggs are laid in November and December and take around eleven days to incubate.,8,0,female_feminine,8,4860
4910,659565,common_voice_en_32698838.mp3,Cooney got into development of Flash games during high school.,8,0,female_feminine,8,5076
4911,306306,common_voice_en_38637.mp3,The omens had told him so.,8,0,female_feminine,8,2376
4912,875576,common_voice_en_35064135.mp3,It led to animosity between the band and Soviet officials.,8,0,female_feminine,8,4572
4913,1657304,common_voice_en_37900384.mp3,This was the starting point of a fabulous treasure hunt.,8,0,female_feminine,8,5148
4914,1150497,common_voice_en_26091.mp3,YOU WANNA TAKE THIS OUTSIDE?,8,0,female_feminine,8,2256
4915,875575,common_voice_en_35064134.mp3,"The village appears in the second Muppet film, ""The Great Muppet Caper"".",8,0,female_feminine,8,4140
4916,875574,common_voice_en_35064118.mp3,The seven popes of the Avignon Papacy were French and are bolded.,8,0,female_feminine,8,4572
4917,659601,common_voice_en_33495785.mp3,The player can then teleport to the new location if desired.,8,0,female_feminine,8,4464
4918,354777,common_voice_en_637941.mp3,"It's too bad that he's quickly going to forget my name, he thought.",8,0,female_feminine,8,3768
4919,1150504,common_voice_en_26098.mp3,"Those are the rules of war, the leader explained.",8,0,female_feminine,8,2976
4920,659566,common_voice_en_32698841.mp3,He came to Puri by the inspiration of Sri Chaitanya.,8,0,female_feminine,8,5220
4921,659598,common_voice_en_33495772.mp3,Born in Kirchberg am Walde.,8,0,female_feminine,8,3312
4922,875572,common_voice_en_35064116.mp3,Few authentic details of his life exist.,8,0,female_feminine,8,3384
4923,637809,common_voice_en_62471.mp3,I heard a faint movement under my feet.,8,0,female_feminine,8,3144
4924,659599,common_voice_en_33495773.mp3,She is being treated in hospital under police guard.,8,0,female_feminine,8,3888
4925,659600,common_voice_en_33495774.mp3,Erskine was banished.,8,0,female_feminine,8,2736
4926,637810,common_voice_en_62472.mp3,And the sand and gravel had been flung violently in every direction.,8,0,female_feminine,8,5112
4927,1662311,common_voice_en_38000908.mp3,"In Greek movies, she acted in comedies as an aunt or a housewife.",12,4,female_feminine,8,6876
4928,354783,common_voice_en_637947.mp3,But she said nothing.,8,0,female_feminine,8,2448
4929,637808,common_voice_en_62470.mp3,"I thought about whether we should find coins and models in it, and so on.",8,0,female_feminine,8,4296
4930,1192997,common_voice_en_32260133.mp3,She met her husband Mister Bates at Blackstone.,8,0,female_feminine,8,3708
4931,1192996,common_voice_en_32260132.mp3,The Ainu have no recorded habit of tying their hair.,8,0,female_feminine,8,4104
4932,1192995,common_voice_en_32260125.mp3,Some of his wealth went into patronage.,8,0,female_feminine,8,2880
4933,1192994,common_voice_en_32260124.mp3,This demand was also unconstitutional for West Germany.,8,0,female_feminine,8,4356
4934,1192993,common_voice_en_32260123.mp3,He and his unit took part in combat operations over Nanjing and other areas.,8,0,female_feminine,8,5328
4935,1192992,common_voice_en_32260122.mp3,There was no sign of sexual assault.,8,0,female_feminine,8,3168
4936,1192991,common_voice_en_32260121.mp3,Edwards lives in Los Angeles.,8,0,female_feminine,8,2952
4937,698862,common_voice_en_32639424.mp3,He refuses to accept reality even when disaster strikes.,8,0,female_feminine,8,5076
4938,1192989,common_voice_en_32260119.mp3,It was directed by Matthew Daniel Siskin.,8,0,female_feminine,8,3564
4939,1192988,common_voice_en_32260118.mp3,She was the mother of the film producer Leo Pescarolo.,8,0,female_feminine,8,3996
4940,1150557,common_voice_en_26151.mp3,He noticed the unequal cooling of its surface.,8,0,female_feminine,8,3336
4941,1192984,common_voice_en_32260113.mp3,Brittney Boston.,8,0,female_feminine,8,2124
4942,1192983,common_voice_en_32260112.mp3,The trail is steep and technical with many exposed rock sections of quartz monzonite.,8,0,female_feminine,8,6228
4943,1192982,common_voice_en_32260111.mp3,Frankie is then born in February.,8,0,female_feminine,8,3096
4944,1192981,common_voice_en_32260110.mp3,Hall earned the Distinguished Flying Cross for his valiant achievements.,8,0,female_feminine,8,4752
4945,1192980,common_voice_en_32260109.mp3,A community center is set up in the northern part of the island.,8,0,female_feminine,8,4032
4946,1192979,common_voice_en_32260108.mp3,He has also captained Brazil on many occasions.,8,0,female_feminine,8,4104
4947,1192978,common_voice_en_32260107.mp3,They lost in the quarterfinals of the Patriot League Tournament to Lafayette.,8,0,female_feminine,8,5184
4948,1192977,common_voice_en_32260106.mp3,She has not remarried.,8,0,female_feminine,8,2412
4949,1192976,common_voice_en_32260105.mp3,From Demerara she sailed to Surinam.,8,0,female_feminine,8,3960
4950,1192975,common_voice_en_32260104.mp3,It follows the developing friendship between the four protagonists of the title.,8,0,female_feminine,8,5220
4951,1192974,common_voice_en_32260100.mp3,It has slender branchlets that are arching or pendulous at the extremities.,8,0,female_feminine,8,5400
4952,1192985,common_voice_en_32260114.mp3,Sometimes it is known as Peruvian black scorpion.,8,0,female_feminine,8,4176
4953,1193016,common_voice_en_32260167.mp3,He wrote poems in Gujarati and Urdu.,8,0,female_feminine,8,3600
4954,1193015,common_voice_en_32260161.mp3,Several of the wines are also named after former mines in the area.,8,0,female_feminine,8,5040
4955,1193014,common_voice_en_32260160.mp3,The Irish state did not intervene to speed up the resolution of the crisis.,8,0,female_feminine,8,5544
4956,1193013,common_voice_en_32260159.mp3,Her past life is not explained.,8,0,female_feminine,8,3204
4957,1193012,common_voice_en_32260158.mp3,Its tailfin is ovoid.,8,0,female_feminine,8,3024
4958,1193011,common_voice_en_32260157.mp3,He attended school in Jersey.,8,0,female_feminine,8,2988
4959,1193010,common_voice_en_32260156.mp3,The fast Fourier transform can be used to do fast convolution of count sketches.,8,0,female_feminine,8,6192
4960,1193009,common_voice_en_32260151.mp3,The power was transmitted via an input gear to the rear axle.,8,0,female_feminine,8,4968
4961,698833,common_voice_en_32639172.mp3,This is thought to be the only surviving example of his work.,8,0,female_feminine,8,4140
4962,1529971,common_voice_en_32115555.mp3,He spent the first years of his life in the United States.,8,0,female_feminine,8,4176
4963,875536,common_voice_en_28370203.mp3,"Here, the fibers synapse and postganglionic fibers join the fibers of the maxillary nerve.",8,0,female_feminine,8,9216
4964,1192999,common_voice_en_32260135.mp3,Artists represented in this collection include,8,0,female_feminine,8,3420
4965,1193008,common_voice_en_32260149.mp3,After both fights ended and players on the Brazilian team were left injured.,8,0,female_feminine,8,5076
4966,875535,common_voice_en_28370202.mp3,The case has been criticized on many grounds.,8,0,female_feminine,8,4392
4967,875534,common_voice_en_28370200.mp3,He published articles and interviews connected with theatre and musical personalities.,8,0,female_feminine,8,6552
4968,1193007,common_voice_en_32260148.mp3,They had three head coaches in their existence.,8,0,female_feminine,8,3348
4969,875533,common_voice_en_28370199.mp3,This high level of sophistication came at a high cost.,8,0,female_feminine,8,4356
4970,1193006,common_voice_en_32260147.mp3,He also served in the United States Merchant Marine.,8,0,female_feminine,8,3636
4971,875532,common_voice_en_28370197.mp3,They can be seen on the wings and vertical tails of many airliners.,8,0,female_feminine,8,5904
4972,1193005,common_voice_en_32260146.mp3,Covfefe is out of Antics by Unbridled.,8,0,female_feminine,8,3924
4973,1193003,common_voice_en_32260144.mp3,There are some rooms for students.,8,0,female_feminine,8,2952
4974,1193001,common_voice_en_32260142.mp3,The tip of the leaf is rounded.,8,0,female_feminine,8,2880
4975,1193000,common_voice_en_32260141.mp3,He was replaced by Wesley Marshall.,8,0,female_feminine,8,2700
4976,682948,common_voice_en_44621.mp3,Henderson stood up with a spade in his hand.,8,0,female_feminine,8,3240
4977,159887,common_voice_en_19192.mp3,"We don't know what's in the confounded thing, do you?",8,0,female_feminine,8,4752
4978,659564,common_voice_en_32698835.mp3,"The name literally translates to ""Mauritian Socialist Party"" in English.",8,0,female_feminine,8,6012
4979,1150427,common_voice_en_26021.mp3,"There must be a language that doesn't depend on words, the boy thought.",8,0,female_feminine,8,3672
4980,1660330,common_voice_en_37962074.mp3,His field of study for his doctorate was atomic and laser physics.,8,0,female_feminine,8,7488
4981,337892,common_voice_en_38619007.mp3,"Later, Whitney's wife, Elizabeth Ann, was added to that group.",8,0,female_feminine,8,6588
4982,659563,common_voice_en_32698831.mp3,The smaller one is the bottle.,8,0,female_feminine,8,4464
4983,159890,common_voice_en_19195.mp3,I was impatient to see it opened.,8,0,female_feminine,8,3576
4984,337880,common_voice_en_38577032.mp3,Kopitar became the first Slovenian-born player to win the Stanley Cup.,8,0,female_feminine,8,6300
4985,1103650,common_voice_en_32156400.mp3,"He is chief editor of the Springer journal ""Chemical and Biological Technologies in Agriculture"".",8,0,female_feminine,8,8568
4986,1521899,common_voice_en_36842165.mp3,"Clive Barnes in a ""New York Times"" review called her performance ""outrageously appealing.",8,0,female_feminine,8,6192
4987,659594,common_voice_en_32825612.mp3,Todd Hunter and Walton Smith were the team captains.,8,0,female_feminine,8,4608
4988,399499,common_voice_en_9749.mp3,You have enough gold to buy many sheep and many camels.,9,1,female_feminine,8,5544
4989,659579,common_voice_en_32699414.mp3,Hall was born at Maseru in British Basutoland.,8,0,female_feminine,8,4896
4990,1150403,common_voice_en_25997.mp3,Imagine if everyone went around transforming lead into gold.,8,0,female_feminine,8,4080
4991,713334,common_voice_en_20285171.mp3,She doesn't want to hide her disability but rather show it with pride.,8,0,female_feminine,8,4488
4992,659561,common_voice_en_32698598.mp3,She was three when her family arrived in Cologne.,8,0,female_feminine,8,4572
4993,689078,common_voice_en_25116867.mp3,It is the fourth-smallest county in Nebraska by area.,8,0,female_feminine,8,4608
4994,659559,common_voice_en_32698593.mp3,Both versions of the show have also won accolades.,8,0,female_feminine,8,4824
4995,659558,common_voice_en_32698590.mp3,Her colleagues in Madras included politician Mona Hensman and physician Muthulakshmi Reddy.,8,0,female_feminine,8,8172
4996,1387316,common_voice_en_38754707.mp3,"He praised Lynne's harmonies, calling them nothing less than righteous.",8,0,female_feminine,8,6840
4997,1657832,common_voice_en_37916322.mp3,Now it is a Municipal Corporation.,10,2,female_feminine,8,4896
4998,114508,common_voice_en_32767778.mp3,The Conservative Party regained control of the council from no overall control.,8,0,female_feminine,8,6156
4999,659562,common_voice_en_32698599.mp3,Whitmore is from Wexford.,8,0,female_feminine,8,3672
5000,659576,common_voice_en_32699068.mp3,There are no records of him being born or marrying in New Zealand.,8,0,female_feminine,8,5112
5001,659575,common_voice_en_32699066.mp3,The jump itself consists of Paskapoo sandstone cliffs.,8,0,female_feminine,8,5616
5002,1531396,common_voice_en_32287056.mp3,All trains run as local services and stop at all stations.,8,0,female_feminine,8,5940
5003,659577,common_voice_en_32699412.mp3,Heidegger played for two years at Crespi Carmelite High School.,8,0,female_feminine,8,5616
5004,659574,common_voice_en_32699065.mp3,The adult bugs overwinter.,8,0,female_feminine,8,3348
5005,1150458,common_voice_en_26052.mp3,The tea seemed less bitter.,8,0,female_feminine,8,2136
5006,698852,common_voice_en_32639330.mp3,Professor of Chemistry at Duke University.,8,0,female_feminine,8,3708
5007,659572,common_voice_en_32699063.mp3,Intermarriages between the Hindus and Sikh community are very common there.,8,0,female_feminine,8,6408
5008,659571,common_voice_en_32698961.mp3,He was married with seven children.,8,0,female_feminine,8,3456
5009,1531325,common_voice_en_32286958.mp3,The campaign ground on during the summer and autumn.,8,0,female_feminine,8,5220
5010,1658711,common_voice_en_37935288.mp3,We love it and hope they will too!,8,0,female_feminine,8,4320
5011,463560,common_voice_en_2639.mp3,Just the ant colony of the neighborhood.,8,0,female_feminine,8,3528
5012,698849,common_voice_en_32639314.mp3,The artist aims to bridge the distance between the viewer and the artist.,8,0,female_feminine,8,4860
5013,1150451,common_voice_en_26045.mp3,It brought his heart into his mouth.,8,0,female_feminine,8,2520
5014,1479244,common_voice_en_34944598.mp3,He was the first African American to serves as Lieutenant Governor in Mississippi.,10,2,female_feminine,8,5220
5015,653023,common_voice_en_37184177.mp3,Its core competency is in fertiliser products.,8,0,female_feminine,8,3996
5016,1103564,common_voice_en_32142953.mp3,"His thesis was titled ""The Reflecting Power of Metals"".",8,0,female_feminine,8,6048
5017,1150443,common_voice_en_26037.mp3,He still had some doubts about the decision he had made.,8,0,female_feminine,8,3072
5018,570379,common_voice_en_132273.mp3,He had seen the shooting star and was persuaded that a meteorite lay somewhere nearby.,8,0,female_feminine,8,5904
5019,995283,common_voice_en_48768.mp3,"When he was a child, that man wanted to travel, too.",8,0,female_feminine,8,3192
5020,659569,common_voice_en_32698957.mp3,It blooms between March and December producing yellow flowers.,8,0,female_feminine,8,5292
5021,659568,common_voice_en_32698954.mp3,She did not qualify for any individual finals.,8,0,female_feminine,8,4428
5022,398699,common_voice_en_83420.mp3,He understands the forces of nature.,8,0,female_feminine,8,4944
5023,768515,common_voice_en_169462.mp3,This was the strangest of all things that ever came to earth from outer space.,8,0,female_feminine,8,5088
5024,1387310,common_voice_en_38754644.mp3,Niels Treschow was the principal of this school.,8,0,female_feminine,8,5436
5025,1657969,common_voice_en_37921630.mp3,Women wear long embroidered skirts and colorful tops.,10,2,female_feminine,8,6336
5026,713352,common_voice_en_20285266.mp3,"It's more of a compliment than anything else, honestly.",8,0,female_feminine,8,4920
5027,659589,common_voice_en_32753437.mp3,Holding the gains over the following weeks under heavy shellfire was very costly.,8,0,female_feminine,8,6264
5028,659590,common_voice_en_32753438.mp3,Thibodeau stressed that digital preservation cannot be separated from the questions of access.,8,0,female_feminine,8,7056
5029,1322283,common_voice_en_38724598.mp3,She said that she was willing to change the party.,8,0,female_feminine,8,3420
5030,659591,common_voice_en_32753439.mp3,He played college basketball for the Washington State Cougars.,8,0,female_feminine,8,4932
5031,713357,common_voice_en_20285286.mp3,"After a short while, Uthman purchased a house of his own and moved there.",8,0,female_feminine,8,4824
5032,301857,common_voice_en_63605.mp3,It had a diameter of about thirty yards.,8,0,female_feminine,8,3312
5033,713339,common_voice_en_20285186.mp3,A footbridge connects the two platforms.,8,0,female_feminine,8,4032
5034,659592,common_voice_en_32825610.mp3,There he attended the high school.,8,0,female_feminine,8,3240
5035,332885,common_voice_en_130165.mp3,"It seemed such a little thing, so bright and small and still.",8,0,female_feminine,8,5184
5036,995307,common_voice_en_48798.mp3,And the leader posted armed sentinels at the fringes of the group.,8,0,female_feminine,8,4680
5037,875579,common_voice_en_35064138.mp3,Air quality index values are typically grouped into ranges.,8,0,female_feminine,8,4500
5038,1223492,common_voice_en_32762167.mp3,His soda fountain became so popular that the line would go out the door.,8,0,female_feminine,8,6660
5039,1478580,common_voice_en_34925184.mp3,This is because files help in storing information permanently.,8,0,female_feminine,8,5328
5040,301867,common_voice_en_63618.mp3,"The level ground was blackened as far as one could see, and it was still giving off smoke.",8,0,female_feminine,8,7128
5041,394402,common_voice_en_18823.mp3,"Of course, the two were unable to do anything.",8,0,female_feminine,8,4104
5042,875578,common_voice_en_35064137.mp3,A fighter squadron consisted of eight to nine fighter planes.,8,0,female_feminine,8,4284
5043,875577,common_voice_en_35064136.mp3,"In everyday terms, the viscosity of a fluid is described as its ""thickness"".",8,0,female_feminine,8,4428
5044,659593,common_voice_en_32825611.mp3,Authorities worried the flames could spark additional wildfires.,8,0,female_feminine,8,4716
5045,1150490,common_voice_en_26084.mp3,But they really don't know what they're saying.,9,1,female_feminine,8,2592
5046,659557,common_voice_en_32698538.mp3,Specifications from Palm Info Center.,8,0,female_feminine,8,4104
5047,713340,common_voice_en_20285187.mp3,Oxygen is then removed by passing the solution through a vacuum de-aeration column.,8,0,female_feminine,8,6528
5048,659556,common_voice_en_32698536.mp3,He was succeeded by Jeffrey Ross Gunter.,8,0,female_feminine,8,4680
5049,659555,common_voice_en_32698533.mp3,Hagedorn himself lost in the Palawan gubernatorial election.,8,0,female_feminine,8,6192
5050,659554,common_voice_en_32698529.mp3,French youth were influenced by American culture to play basketball.,8,0,female_feminine,8,6120
5051,1150380,common_voice_en_25974.mp3,He told them all to be seated.,8,0,female_feminine,8,1992
5052,349518,common_voice_en_32072478.mp3,The audio rights were acquired by Ayngaran International.,8,0,female_feminine,8,6948
5053,475624,common_voice_en_583906.mp3,He remembered the sword.,8,0,female_feminine,8,2328
5054,659580,common_voice_en_32699416.mp3,Four operational areas of Central Coalfields are marked on the map.,8,0,female_feminine,8,5688
5055,759730,common_voice_en_32804718.mp3,This edition was also the first edition where cities were no longer represented.,8,0,female_feminine,8,6156
5056,1521646,common_voice_en_36746064.mp3,Grey and Markham were reprieved.,8,0,female_feminine,8,2952
5057,456447,common_voice_en_36566155.mp3,"In his prime he was dubbed the ""Latvian Michael Owen"".",8,0,female_feminine,8,5904
5058,1488987,common_voice_en_38682905.mp3,In time the nickname was added to his surname.,8,0,female_feminine,8,3996
5059,281086,common_voice_en_13769.mp3,I'd like you to take me there if you can.,9,1,female_feminine,8,3792
5060,659584,common_voice_en_32699491.mp3,His favourite subject in school is Mathematics.,8,0,female_feminine,8,4140
5061,659585,common_voice_en_32699492.mp3,Admission to the event is free and open to the public.,8,0,female_feminine,8,4572
5062,1663465,common_voice_en_38020215.mp3,Nor does he stop here.,8,0,female_feminine,8,2916
5063,605914,common_voice_en_30125810.mp3,Flowering occurs from September to January.,8,0,female_feminine,8,4644
5064,659586,common_voice_en_32699493.mp3,The following is the list of the Basel first team squad.,8,0,female_feminine,8,5076
5065,301864,common_voice_en_63615.mp3,It seemed so safe and tranquil.,10,2,female_feminine,8,3624
5066,509379,common_voice_en_134309.mp3,I wished I had a light to smoke by.,8,0,female_feminine,8,3672
5067,659588,common_voice_en_32753436.mp3,The video was inspired by science fiction and anime.,8,0,female_feminine,8,4572
5068,114507,common_voice_en_32767776.mp3,He played college football for North Dakota State.,8,0,female_feminine,8,4860
5069,509387,common_voice_en_134318.mp3,That sobered him a little.,8,0,female_feminine,8,2664
5070,1192856,common_voice_en_32259947.mp3,Analysts regarded him as the consensus number one pick in the draft.,8,0,female_feminine,8,4644
5071,1192855,common_voice_en_32259946.mp3,Guest lecturer at the University of Birmingham in England.,8,0,female_feminine,8,3924
5072,1192854,common_voice_en_32259945.mp3,The agency builds housing for low income families throughout Bangladesh.,8,0,female_feminine,8,4824
5073,1192853,common_voice_en_32259944.mp3,Her ancestors initially were manufacturers.,8,0,female_feminine,8,3636
5074,1192852,common_voice_en_32259943.mp3,She succeeded fellow Republican Mike Cunningham.,8,0,female_feminine,8,3564
5075,1192851,common_voice_en_32259942.mp3,She also collected Peruvian paintings.,8,0,female_feminine,8,3348
5076,1192850,common_voice_en_32259941.mp3,The road merges and becomes Juan Luna Avenue.,8,0,female_feminine,8,3780
5077,1192848,common_voice_en_32259939.mp3,The three were sailing to Liverpool from Demerara.,8,0,female_feminine,8,3780
5078,1192847,common_voice_en_32259938.mp3,He participates in many political events and conferences of the city and country.,8,0,female_feminine,8,4968
5079,1192846,common_voice_en_32259937.mp3,There he would drive around the city and rescue civilians wounded by artillery fire.,8,0,female_feminine,8,5328
5080,1192845,common_voice_en_32259936.mp3,Her baskets have been featured in collections and exhibitions throughout Utah.,8,0,female_feminine,8,5040
5081,1192884,common_voice_en_32259978.mp3,The fur every time grows back quickly at three months even when being shaved.,8,0,female_feminine,8,5616
5082,1192843,common_voice_en_32259934.mp3,Long Live the Republic!,8,0,female_feminine,8,2376
5083,67554,common_voice_en_37983188.mp3,"I mean, where's the walrus?",8,0,female_feminine,8,4572
5084,1192874,common_voice_en_32259967.mp3,Other notable tornadoes struck in Cheshire and Shropshire.,8,0,female_feminine,8,4104
5085,1192841,common_voice_en_32259932.mp3,Also several other members of her family were handball players.,8,0,female_feminine,8,4500
5086,1109855,common_voice_en_31961343.mp3,Music for this film was composed by Koti.,8,0,female_feminine,8,4608
5087,1192839,common_voice_en_32259930.mp3,The American Civil Liberties Union opposes the legislation.,8,0,female_feminine,8,4320
5088,682970,common_voice_en_44643.mp3,"It was glaringly hot, not a cloud in the sky nor a breath of wind.",8,0,female_feminine,8,6072
5089,698853,common_voice_en_32639331.mp3,He thrived on competition.,8,0,female_feminine,8,2700
5090,1192836,common_voice_en_32259927.mp3,He has also published prolifically on these subjects.,8,0,female_feminine,8,3924
5091,1192835,common_voice_en_32259926.mp3,Striking workers were attacked by police forces.,8,0,female_feminine,8,3924
5092,1192834,common_voice_en_32259925.mp3,Unknown error.,8,0,female_feminine,8,1980
5093,1192844,common_voice_en_32259935.mp3,She was the first interpreter of many works of her repertoire.,8,0,female_feminine,8,4212
5094,1192882,common_voice_en_32259976.mp3,Inflorescences have solitary flowers.,8,0,female_feminine,8,3924
5095,1192881,common_voice_en_32259974.mp3,He also served as President of the Pontifical Committee for International Eucharistic Congresses.,8,0,female_feminine,8,6228
5096,1192880,common_voice_en_32259973.mp3,It then pours into the Jaune River.,8,0,female_feminine,8,3060
5097,1192879,common_voice_en_32259972.mp3,Payne previously served in the Minneapolis office of Performance and Innovation.,8,0,female_feminine,8,5220
5098,698856,common_voice_en_32639402.mp3,No known remains survive.,8,0,female_feminine,8,2880
5099,1192876,common_voice_en_32259969.mp3,It is the largest mosque in Djibouti.,8,0,female_feminine,8,3204
5100,1192875,common_voice_en_32259968.mp3,Monsters.,8,0,female_feminine,8,1944
5101,1192906,common_voice_en_32260003.mp3,She was an associate attorney at Clifford Chance in London.,8,0,female_feminine,8,4428
5102,1192872,common_voice_en_32259965.mp3,The songs vary in tone from lovingly addressed to determined to escape the relationship.,8,0,female_feminine,8,5832
5103,1192871,common_voice_en_32259964.mp3,Precision railroading has been criticized on many fronts.,8,0,female_feminine,8,4320
5104,1192870,common_voice_en_32259963.mp3,"The jail has been nicknamed ""The Farm"" due to its early agricultural operations.",8,0,female_feminine,8,5364
5105,1192857,common_voice_en_32259948.mp3,Dayton won the regular season.,8,0,female_feminine,8,2844
5106,1192868,common_voice_en_32259960.mp3,It also has vertically ascending tubular outlets.,8,0,female_feminine,8,4104
5107,1192867,common_voice_en_32259959.mp3,Her husband had died ten years earlier.,8,0,female_feminine,8,3348
5108,1192866,common_voice_en_32259958.mp3,His body is put in his car which is driven away by Sam.,8,0,female_feminine,8,4356
5109,1192865,common_voice_en_32259957.mp3,"Multiple media sources in the music industry have expressed their criticism towards ""Altogether"".",8,0,female_feminine,8,6156
5110,1192864,common_voice_en_32259955.mp3,I took it off and replaced it with my face.,8,0,female_feminine,8,3204
5111,1192863,common_voice_en_32259954.mp3,The exhibit also highlights piercing pioneers Horst Streckenbach and Ethel Granger.,8,0,female_feminine,8,6084
5112,1192862,common_voice_en_32259953.mp3,The player can jump and hang from ledges.,8,0,female_feminine,8,3060
5113,1192861,common_voice_en_32259952.mp3,Georgia defeated Cyprus in the final to win the tournament.,8,0,female_feminine,8,3996
5114,698854,common_voice_en_32639332.mp3,The field lines for railways are close everywhere.,8,0,female_feminine,8,4320
5115,682968,common_voice_en_44641.mp3,I'm going to them.,8,0,female_feminine,8,2544
5116,1192890,common_voice_en_32259984.mp3,Patterned columns support the doorway.,8,0,female_feminine,8,3060
5117,1192869,common_voice_en_32259961.mp3,The term often carries negative connotations.,8,0,female_feminine,8,3744
5118,1192806,common_voice_en_32259895.mp3,"She accompany with production company ""Little Bird"" to make documentaries.",8,0,female_feminine,8,5184
5119,1192805,common_voice_en_32259889.mp3,"He is set to star in the episode ""Zero Feet Away"" opposite Max Jenkins.",8,0,female_feminine,8,5796
5120,1192804,common_voice_en_32259883.mp3,Daily Collegian was also surprised that Wonder contributed to the track.,8,0,female_feminine,8,5400
5121,1192803,common_voice_en_32259882.mp3,This early Griffith production is therefore currently classified as lost.,8,0,female_feminine,8,5508
5122,1192802,common_voice_en_32259881.mp3,He seized power after the death of his predecessor.,8,0,female_feminine,8,3780
5123,1192800,common_voice_en_32259874.mp3,"The ""M"" designation was previously used for Apple motion coprocessors.",8,0,female_feminine,8,5940
5124,1192799,common_voice_en_32259873.mp3,Mojo Pizza claims to serve double toppings on their pizzas.,8,0,female_feminine,8,4644
5125,1192798,common_voice_en_32259872.mp3,Marzorati represented the Belgian government to this commission.,8,0,female_feminine,8,4788
5126,1192797,common_voice_en_32259870.mp3,It was produced by Royston Morley.,8,0,female_feminine,8,3492
5127,1192796,common_voice_en_32259869.mp3,Rayford Logan was his lifelong mentor.,8,0,female_feminine,8,3636
5128,1192795,common_voice_en_32259863.mp3,Patil was married to actor Raj Babbar.,8,0,female_feminine,8,4284
5129,1192832,common_voice_en_32259923.mp3,They drenched her in kerosene and later set her on fire.,8,0,female_feminine,8,3780
5130,1192793,common_voice_en_32259858.mp3,There is no entrance exam to start attending this program.,8,0,female_feminine,8,4860
5131,1192792,common_voice_en_32259857.mp3,Soundtrack is available on Tips Music.,8,0,female_feminine,8,3960
5132,1192791,common_voice_en_32259849.mp3,Reception to the novel was generally positive.,8,0,female_feminine,8,4032
5133,1192790,common_voice_en_32259847.mp3,Fuminori Kizaki will direct the film at Polygon Pictures.,8,0,female_feminine,8,4176
5134,1192789,common_voice_en_32259841.mp3,Yuqing Temple is the first temple in Miaoli County to not burn joss paper.,8,0,female_feminine,8,6372
5135,1192788,common_voice_en_32259835.mp3,These films were selected based on submitted scripts.,8,0,female_feminine,8,4644
5136,1192787,common_voice_en_32249410.mp3,The Marlins remained in Philadelphia pending further testing.,8,0,female_feminine,8,4968
5137,1192786,common_voice_en_32249409.mp3,Hudson.,8,0,female_feminine,8,2268
5138,1192785,common_voice_en_32249407.mp3,Pixar produced the project alongside Supper Club.,8,0,female_feminine,8,4716
5139,1192784,common_voice_en_32249406.mp3,On high holy days the painting would be raised to show the statue.,8,0,female_feminine,8,5400
5140,1480100,common_voice_en_37081974.mp3,These levels were significantly lower with other edible oils.,8,0,female_feminine,8,4716
5141,1192826,common_voice_en_32259917.mp3,It was in Kan Su she nursed the wounded at the military base hospital.,8,0,female_feminine,8,5364
5142,1192831,common_voice_en_32259922.mp3,The first Sculcoates plant comprised Willans engines coupled directly to Siemens and Holmes dynamos.,8,0,female_feminine,8,6732
5143,403964,common_voice_en_191453.mp3,I was impatient to see it opened.,8,0,female_feminine,8,2712
5144,1192829,common_voice_en_32259920.mp3,She frequented many lectures at Midwestern State University.,8,0,female_feminine,8,4716
5145,1192828,common_voice_en_32259919.mp3,The Institute was originally known as the Institute of West Australian Architects.,8,0,female_feminine,8,5760
5146,691187,common_voice_en_148764.mp3,It had a diameter of about thirty yards.,8,0,female_feminine,8,5208
5147,1192827,common_voice_en_32259918.mp3,The court also found that the original private prosecution application vexatious in nature.,8,0,female_feminine,8,6264
5148,1192825,common_voice_en_32259916.mp3,"The show is the third season of the ""Youth With You"" series.",8,0,female_feminine,8,4500
5149,1192822,common_voice_en_32259913.mp3,The station is currently active.,8,0,female_feminine,8,2556
5150,1192821,common_voice_en_32259912.mp3,Jimenez had also disappeared and his car was nowhere to be found.,8,0,female_feminine,8,4248
5151,1192820,common_voice_en_32259911.mp3,The Democratic Party in the county had few African Americans before his pioneering efforts.,8,0,female_feminine,8,6480
5152,1192819,common_voice_en_32259909.mp3,Stephens is the father of five children.,8,0,female_feminine,8,3312
5153,1192807,common_voice_en_32259896.mp3,Its use is widespread among numerous North African tribes.,8,0,female_feminine,8,4824
5154,1192817,common_voice_en_32259907.mp3,The piece is part of the collection of the Athens School of Fine Arts.,8,0,female_feminine,8,4680
5155,698820,common_voice_en_32639109.mp3,The three losers from the first round entered this round.,8,0,female_feminine,8,4248
5156,1192816,common_voice_en_32259906.mp3,A striking red book can be seen through the skeleton.,8,0,female_feminine,8,3996
5157,1192815,common_voice_en_32259905.mp3,Each team gets one half of the court at the start.,8,0,female_feminine,8,3744
5158,1192814,common_voice_en_32259904.mp3,Los Angeles lost to the Philadelphia Fusion the following match.,8,0,female_feminine,8,4608
5159,1192813,common_voice_en_32259903.mp3,The club moved to secure funding through The Football Stadia Improvement Fund.,8,0,female_feminine,8,5364
5160,1192812,common_voice_en_32259902.mp3,I will remit the whole balance due from you.,8,0,female_feminine,8,2844
5161,1192842,common_voice_en_32259933.mp3,In this album he participated as one of the main musicians.,8,0,female_feminine,8,4176
5162,1657359,common_voice_en_37907031.mp3,The outline of the site's defences can still be clearly seen.,8,0,female_feminine,8,5328
5163,557259,common_voice_en_608096.mp3,There were lights in the upper windows of the houses when the people went to bed.,8,0,female_feminine,8,5304
5164,1192809,common_voice_en_32259899.mp3,Videotape was expensive then and networks did not believe old games were worth saving.,8,0,female_feminine,8,6048
5165,1192808,common_voice_en_32259897.mp3,He wrote books about music and musicians and wrote reviews for music magazines.,8,0,female_feminine,8,5796
5166,1192818,common_voice_en_32259908.mp3,Each participant faces all nine other wrestlers within the same block in singles matches.,8,0,female_feminine,8,6408
5167,1192970,common_voice_en_32260094.mp3,It seems not to be known which Claud Hamilton this was.,8,0,female_feminine,8,4644
5168,1192937,common_voice_en_32260042.mp3,It is divided into several segments with different shapes and heights.,8,0,female_feminine,8,4644
5169,1192935,common_voice_en_32260040.mp3,Forestry is the main economic activity in the sector.,8,0,female_feminine,8,4140
5170,1192934,common_voice_en_32260039.mp3,The final season covers the last showdown between Raylan and Boyd.,8,0,female_feminine,8,4824
5171,1192933,common_voice_en_32260038.mp3,She was an expert in staphylococcal infections.,8,0,female_feminine,8,3636
5172,1192932,common_voice_en_32260037.mp3,The line suffered greatly from competition by bus services.,8,0,female_feminine,8,4356
5173,1192930,common_voice_en_32260035.mp3,Hutton was married twice.,8,0,female_feminine,8,2808
5174,329669,common_voice_en_57349.mp3,It brought his heart into his mouth.,8,0,female_feminine,8,3816
5175,1192929,common_voice_en_32260034.mp3,"He also starred in ""Deep Inside of Me"".",8,0,female_feminine,8,3600
5176,1192928,common_voice_en_32260032.mp3,Dorsum is covered with smooth granular scales.,8,0,female_feminine,8,4212
5177,1192927,common_voice_en_32260031.mp3,At the Bahamas she was sold.,8,0,female_feminine,8,2556
5178,1192914,common_voice_en_32260011.mp3,Mannix Library is part of the larger University of Divinity library network.,8,0,female_feminine,8,5616
5179,1192925,common_voice_en_32260028.mp3,Laredo won the second–half championship.,8,0,female_feminine,8,3204
5180,1192924,common_voice_en_32260027.mp3,At this time the arena was modified to accommodate hockey and other team sports.,8,0,female_feminine,8,5544
5181,1192923,common_voice_en_32260026.mp3,"Samples from the demo would later be used in ""Musician"".",8,0,female_feminine,8,4032
5182,1192954,common_voice_en_32260067.mp3,The Cowboys lost both of those games to the Pittsburgh Steelers.,8,0,female_feminine,8,4536
5183,1192921,common_voice_en_32260023.mp3,It was eventually nominated for an Academy Award.,8,0,female_feminine,8,3564
5184,698861,common_voice_en_32639423.mp3,His research areas include linguistics and language teaching.,8,0,female_feminine,8,4680
5185,1223733,common_voice_en_35299881.mp3,"Soon after, member Linnie Belcher left the group and group remained as a trio.",8,0,female_feminine,8,7668
5186,1192919,common_voice_en_32260021.mp3,The entire work was carried on the basis of ancient palm leaf manuscripts.,8,0,female_feminine,8,5184
5187,1192918,common_voice_en_32260020.mp3,They compete in the West Division of the Sun Belt Conference.,8,0,female_feminine,8,3888
5188,1192917,common_voice_en_32260019.mp3,It won her the Lomonosov Award of the Academy of Sciences.,8,0,female_feminine,8,4536
5189,1192916,common_voice_en_32260018.mp3,He suspected his wife of adultery and quarreled with her over it.,8,0,female_feminine,8,4536
5190,1192915,common_voice_en_32260017.mp3,They are usually awarded during the Amsterdam International Water Week.,8,0,female_feminine,8,5004
5191,1192926,common_voice_en_32260030.mp3,He was diocesan president of Catholic Action in Caserta.,8,0,female_feminine,8,4320
5192,1192783,common_voice_en_32249400.mp3,He also obtained commissions for church furniture such as pulpits and statues of saints.,8,0,female_feminine,8,6876
5193,1192971,common_voice_en_32260095.mp3,The brooches were given to suffragettes upon their release from Holloway.,8,0,female_feminine,8,4680
5194,1192969,common_voice_en_32260093.mp3,The Venado Formation is one of few Ordovician formations outcropping in Colombia.,8,0,female_feminine,8,6228
5195,1192968,common_voice_en_32260092.mp3,Having converted to Buddhism she became Archivist for the Buddhist Society.,8,0,female_feminine,8,5328
5196,1192967,common_voice_en_32260091.mp3,"He also stated his opinion that ""Tiger King"" was spun for entertainment.",8,0,female_feminine,8,5256
5197,1192965,common_voice_en_32260084.mp3,The film received critical acclaim and screened in many international film festivals.,8,0,female_feminine,8,5724
5198,1192964,common_voice_en_32260083.mp3,He retired as superintendent of the Columbus public schools.,8,0,female_feminine,8,4500
5199,1192963,common_voice_en_32260082.mp3,Tonga received one tripartite invitation quota from the International Weightlifting Federation.,8,0,female_feminine,8,6480
5200,329672,common_voice_en_57352.mp3,Henderson stood up with a spade in his hand.,8,0,female_feminine,8,3624
5201,1192962,common_voice_en_32260081.mp3,The single features musician Clara La San.,8,0,female_feminine,8,3636
5202,1192959,common_voice_en_32260078.mp3,Drower came from an accomplished family.,8,0,female_feminine,8,3420
5203,1192939,common_voice_en_32260044.mp3,Mo Bei (Godfrey Gao) is the hotshot lawyer who specializes in commercial law.,8,0,female_feminine,8,5904
5204,1192957,common_voice_en_32260075.mp3,Some of the hearths were lined with stone.,8,0,female_feminine,8,2988
5205,1192956,common_voice_en_32260070.mp3,The seeds are eventually dispersed by means of the wind.,8,0,female_feminine,8,3816
5206,1192953,common_voice_en_32260066.mp3,It was shot in Perth.,8,0,female_feminine,8,2340
5207,1192952,common_voice_en_32260065.mp3,Bailey Washington survived his wife and many of his children.,8,0,female_feminine,8,4500
5208,1192950,common_voice_en_32260063.mp3,He is now remembered as Saheed (martyr) Saroj Koirala.,8,0,female_feminine,8,5220
5209,1192949,common_voice_en_32260062.mp3,He also returned kicks for the Greyhounds.,8,0,female_feminine,8,3744
5210,1192948,common_voice_en_32260061.mp3,Antennas testaceous.,8,0,female_feminine,8,2988
5211,1192947,common_voice_en_32260060.mp3,The Maryland State Athletic Commission will also conduct an investigation.,8,0,female_feminine,8,5076
5212,1192946,common_voice_en_32260059.mp3,He was buried at the Chattanooga National Cemetery.,8,0,female_feminine,8,3780
5213,1192944,common_voice_en_32260051.mp3,I may mention that different clubs in the Homeland play different styles.,8,0,female_feminine,8,5040
5214,1192943,common_voice_en_32260050.mp3,The influx of Rohingya refugees had impact on the demography of Bangladesh.,8,0,female_feminine,8,5400
5215,1192940,common_voice_en_32260045.mp3,Byzantine riddles include many whose solution is arrived at through clues based on spelling.,8,0,female_feminine,8,6156
5216,1192958,common_voice_en_32260077.mp3,The match format is extremely uncommon as it is traditionally not handicapped.,8,0,female_feminine,8,5652
5217,698858,common_voice_en_32639405.mp3,Takano had to work to support the family immediately after graduating from elementary school.,8,0,female_feminine,8,6660
5218,1192908,common_voice_en_32260005.mp3,He has two sons and two daughters.,8,0,female_feminine,8,3240
5219,1387160,common_voice_en_38712005.mp3,It is the oldest aircraft company in the region.,8,0,female_feminine,8,4536
5220,193364,common_voice_en_37822711.mp3,A memorial service was held for him as Grace Cathedral in San Francisco.,8,0,female_feminine,8,5976
5221,698859,common_voice_en_32639406.mp3,His brother John Duncan Dunn was also an architect of golf courses.,8,0,female_feminine,8,5616
5222,1192898,common_voice_en_32259993.mp3,He is the current manager of Aragua.,8,0,female_feminine,8,3096
5223,489362,common_voice_en_71807.mp3,And one or two persons were returning.,8,0,female_feminine,8,3696
5224,1192907,common_voice_en_32260004.mp3,He is Former Youth Congress President of Maharashtra.,8,0,female_feminine,8,4320
5225,1192896,common_voice_en_32259990.mp3,It can natively connect to Azure Cloud Shell.,8,0,female_feminine,8,3600
5226,1192905,common_voice_en_32260002.mp3,Souza decided to go swimming and he drowned.,8,0,female_feminine,8,3600
5227,1192904,common_voice_en_32260001.mp3,He was reported to have the largest collection of jokes in the world.,8,0,female_feminine,8,4572
5228,1192894,common_voice_en_32259988.mp3,This structure was founded to bridge French wines and spirits with the American market.,8,0,female_feminine,8,5688
5229,1192903,common_voice_en_32259998.mp3,He appeared in six games between the Montgomery Biscuits and the Durham Bulls.,8,0,female_feminine,8,5436
5230,1192899,common_voice_en_32259994.mp3,Her first thee promotions coincided with her pregnancies.,8,0,female_feminine,8,4536
5231,698860,common_voice_en_32639422.mp3,A ropes course was added later.,8,0,female_feminine,8,3168
5232,1192902,common_voice_en_32259997.mp3,It is arguably the work in which Wilde first found his own poetic voice.,8,0,female_feminine,8,5112
5233,1192901,common_voice_en_32259996.mp3,Silas Sykes Harmon.,8,0,female_feminine,8,2916
5234,1192938,common_voice_en_32260043.mp3,Each question has two options and the right answer depends on the popular choice.,8,0,female_feminine,8,5616
5235,1192897,common_voice_en_32259992.mp3,It is distributed in the Oriental realm.,8,0,female_feminine,8,3492
5236,1192911,common_voice_en_32260008.mp3,Ralph Nelson was the director and John Gay the writer.,8,0,female_feminine,8,4356
5237,1192887,common_voice_en_32259981.mp3,She turned to other villagers to apologize but they too suffered the same fate.,8,0,female_feminine,8,5616
5238,1192909,common_voice_en_32260006.mp3,He later changed his allegiance to Spain.,8,0,female_feminine,8,3456
5239,698857,common_voice_en_32639403.mp3,Her act also worked on radio.,8,0,female_feminine,8,3528
5240,1192889,common_voice_en_32259983.mp3,Ash trees and hazel grow on the scree slopes of the dale sides.,8,0,female_feminine,8,5364
5241,1192886,common_voice_en_32259980.mp3,Pollination occurs through visits to the flower heads by species of rats and mice.,8,0,female_feminine,8,6192
5242,489366,common_voice_en_71811.mp3,The only shadow was that of the few scattered pine trees.,8,0,female_feminine,8,5784
5243,1192885,common_voice_en_32259979.mp3,He was the most influential sculptor of his generation.,8,0,female_feminine,8,4068
5244,1192922,common_voice_en_32260024.mp3,The Oaks won the pennant by one game over the Vernon Tigers.,8,0,female_feminine,8,4320
5245,1192972,common_voice_en_32260096.mp3,He would be replaced by Buddy Gorman for the next seven films.,8,0,female_feminine,8,4392
5246,1192891,common_voice_en_32259985.mp3,Thou shalt not be selfish.,8,0,female_feminine,8,2700
5247,1192913,common_voice_en_32260010.mp3,He falls in love with his cousin Kashi but she loves someone else.,8,0,female_feminine,8,4896
5248,924755,common_voice_en_541105.mp3,"Looking through the telescope, I saw a circle of deep blue and the little round planet.",7,0,female_feminine,7,7008
5249,227618,common_voice_en_101258.mp3,"I need you to be spontaneous. He asked me out to ""din din.""",7,0,female_feminine,7,5232
5250,357614,common_voice_en_511865.mp3,Most meteorites are more or less rounded.,7,0,female_feminine,7,4728
5251,713661,common_voice_en_604386.mp3,The top of the cylinder was rotating on its body.,7,0,female_feminine,7,3864
5252,912918,common_voice_en_21938.mp3,They said nothing else.,7,0,female_feminine,7,3624
5253,721369,common_voice_en_635050.mp3,"It would have been visible to me, had I only looked up as it passed.",7,0,female_feminine,7,7296
5254,1466912,common_voice_en_22305767.mp3,"The story is simply this, said the painter after some time.",8,1,female_feminine,7,5064
5255,219023,common_voice_en_10055.mp3,"So he began to wander through the city, and found himself at the gates.",7,0,female_feminine,7,5976
5256,924749,common_voice_en_541098.mp3,There were lights in the upper windows of the houses when the people went to bed.,7,0,female_feminine,7,5136
5257,566824,common_voice_en_53492.mp3,What was written on the Emerald Tablet? the boy wanted to know.,8,1,female_feminine,7,5064
5258,227612,common_voice_en_101252.mp3,"There were raised voices,and some sort of struggle appeared to be going on. .",7,0,female_feminine,7,4800
5259,711855,common_voice_en_42090.mp3,I was impatient to see it opened.,7,0,female_feminine,7,4224
5260,438094,common_voice_en_56985.mp3,Then suddenly he noticed it with a start.,7,0,female_feminine,7,3864
5261,713388,common_voice_en_20285586.mp3,"He is best known for his distinctive vignettes of English gardens, landscapes, and architecture.",7,0,female_feminine,7,6888
5262,711858,common_voice_en_42093.mp3,It looked like a rusty gas float.,8,1,female_feminine,7,5304
5263,454600,common_voice_en_60077.mp3,"The woman said she had never heard of such a person, and hurried away.",7,0,female_feminine,7,6000
5264,463573,common_voice_en_2653.mp3,She had her cardigan on.,7,0,female_feminine,7,2400
5265,995192,common_voice_en_48659.mp3,"It's too bad that he's quickly going to forget my name, he thought.",7,0,female_feminine,7,5112
5266,995217,common_voice_en_48693.mp3,"I'm surprised, the boy said.",7,0,female_feminine,7,3144
5267,567294,common_voice_en_83154.mp3,"It was glaringly hot, not a cloud in the sky nor a breath of wind.",7,0,female_feminine,7,3864
5268,454594,common_voice_en_60071.mp3,I don't want anything else in life.,7,0,female_feminine,7,3936
5269,329671,common_voice_en_57351.mp3,"Why the shots stopped after the tenth, no one on earth has tried to explain.",7,0,female_feminine,7,6024
5270,739333,common_voice_en_18325868.mp3,"Compared to other countries in the world, Japan has a very low birth rate.",7,0,female_feminine,7,4104
5271,437781,common_voice_en_200069.mp3,"For at that time, it had not occurred to him that it might be hollow.",7,0,female_feminine,7,6384
5272,219017,common_voice_en_10049.mp3,But in his heart he knew that it did matter.,7,0,female_feminine,7,5016
5273,566844,common_voice_en_53512.mp3,The boy was shocked.,7,0,female_feminine,7,2184
5274,713375,common_voice_en_20285384.mp3,There was also one service per day arriving at Aberdeen from Leeds.,7,0,female_feminine,7,4752
5275,220306,common_voice_en_13538.mp3,The thought was so dreadful to him that he forgot about the heat and went forward.,8,1,female_feminine,7,5832
5276,178897,common_voice_en_108280.mp3,And the sand and gravel had been flung violently in every direction.,7,0,female_feminine,7,5760
5277,924775,common_voice_en_541127.mp3,He was immensely excited at the news.,7,0,female_feminine,7,4152
5278,863822,common_voice_en_683087.mp3,I had seen all that it would presently bring me.,7,0,female_feminine,7,4104
5279,713350,common_voice_en_20285234.mp3,"In Laconia, she has a sanctuary, where she answers people's questions about dreams.",7,0,female_feminine,7,6432
5280,457269,common_voice_en_598979.mp3,The newspaper articles had prepared everyone for the reception of the idea.,7,0,female_feminine,7,6984
5281,819220,common_voice_en_680203.mp3,And one or two persons were returning.,7,0,female_feminine,7,3384
5282,509394,common_voice_en_134325.mp3,It seemed to him that it fell to earth about one hundred miles east of here.,7,0,female_feminine,7,4944
5283,995191,common_voice_en_48657.mp3,There was no way for everybody to know about alchemy.,7,0,female_feminine,7,4536
5284,455638,common_voice_en_60582.mp3,"He had suddenly remembered that, in Tarifa, there was an old woman who interpreted dreams.",7,0,female_feminine,7,7224
5285,924867,common_voice_en_541230.mp3,The streamer of gas came out towards us.,7,0,female_feminine,7,4056
5286,538820,common_voice_en_573359.mp3,This morning I found a calculator taped to my Wii.,7,0,female_feminine,7,3432
5287,509391,common_voice_en_134322.mp3,Strange images passed through my mind.,7,0,female_feminine,7,3024
5288,1275903,common_voice_en_17718790.mp3,"Unfortunately, nobody can warrant that the sanctions will have an effect on the community.",7,0,female_feminine,7,6312
5289,1275936,common_voice_en_17910171.mp3,What is he like?,7,0,female_feminine,7,2952
5290,630733,common_voice_en_48217.mp3,"The boy fell to the sand, nearly unconscious.",7,0,female_feminine,7,3600
5291,914421,common_voice_en_486655.mp3,The guy thought he was a lunatic at large and made an unsuccessful attempt to stop him.,7,0,female_feminine,7,7824
5292,509367,common_voice_en_134297.mp3,I had seen all that it would presently bring me.,7,0,female_feminine,7,3696
5293,863861,common_voice_en_683128.mp3,But I found it difficult to get to work because of the investigations.,7,0,female_feminine,7,5424
5294,334587,common_voice_en_619895.mp3,My review of the sun: one star.,7,0,female_feminine,7,3144
5295,713370,common_voice_en_20285354.mp3,Liberty's drama program is also involved with the International Thespian Society.,8,1,female_feminine,7,6072
5296,713369,common_voice_en_20285333.mp3,Timothy played Herriot in the television series.,7,0,female_feminine,7,4104
5297,713347,common_voice_en_20285228.mp3,"Equatorial Guinea's policies, as defined by law, comprise an open investment regime.",8,1,female_feminine,7,6552
5298,499680,common_voice_en_632264.mp3,Scattered groups of people were hurrying from the direction of Woking.,7,0,female_feminine,7,4440
5299,630723,common_voice_en_48206.mp3,The two men hurried back and found the cylinder still lying in the same position.,7,0,female_feminine,7,5592
5300,713345,common_voice_en_20285209.mp3,"The younger man developed the property as an estate known as ""Clermont"".",8,1,female_feminine,7,5256
5301,913000,common_voice_en_22022.mp3,"Speak to the hand that wrote all, said the sun.",7,0,female_feminine,7,5016
5302,1179952,common_voice_en_29650461.mp3,The politically inexperienced Jacqueline now had to fight for her inheritance.,7,0,female_feminine,7,5580
5303,587905,common_voice_en_651169.mp3,Tangier is not like the rest of Africa.,7,0,female_feminine,7,4200
5304,924793,common_voice_en_541148.mp3,It left a greenish streak that glowed for some seconds.,7,0,female_feminine,7,5784
5305,587874,common_voice_en_651138.mp3,But you don't know about love.,7,0,female_feminine,7,4008
5306,721352,common_voice_en_635029.mp3,"There were raised voices,and some sort of struggle appeared to be going on. .",7,0,female_feminine,7,6264
5307,336783,common_voice_en_171355.mp3,"Some went away while I was there, and other people came.",7,0,female_feminine,7,4272
5308,1235479,common_voice_en_37538620.mp3,These subgroups can be described as denominations.,7,0,female_feminine,7,4068
5309,630732,common_voice_en_48216.mp3,He had understood the story the old king had told him.,7,0,female_feminine,7,4296
5310,336776,common_voice_en_171348.mp3,What had been next to him five minutes ago was now at the other side.,7,0,female_feminine,7,5880
5311,914399,common_voice_en_486633.mp3,"He moved about, invisible but everyone could hear him.",7,0,female_feminine,7,6048
5312,566831,common_voice_en_53499.mp3,What kind of blow should one deliver next in order to remain alive?,7,0,female_feminine,7,6696
5313,332881,common_voice_en_130161.mp3,It brought his heart into his mouth.,7,0,female_feminine,7,3360
5314,538874,common_voice_en_59374.mp3,I myself heard nothing of that.,7,0,female_feminine,7,2424
5315,932681,common_voice_en_70772.mp3,On the very first page it described a burial ceremony.,7,0,female_feminine,7,4272
5316,924832,common_voice_en_541192.mp3,"It would have been visible to me, had I only looked up as it passed.",7,0,female_feminine,7,6096
5317,590963,common_voice_en_586039.mp3,"In spite of this, I still believed that there were men in Mars.",7,0,female_feminine,7,6504
5318,924837,common_voice_en_541198.mp3,It was faintly marked with transverse stripes and slightly flattened from the perfect round.,7,0,female_feminine,7,6504
5319,538888,common_voice_en_59390.mp3,"Besides that, there was a heap of bicycles.",7,0,female_feminine,7,3312
5320,438095,common_voice_en_56986.mp3,The newspaper articles had prepared everyone for the reception of the idea.,7,0,female_feminine,7,6288
5321,455618,common_voice_en_60561.mp3,And you've told me about omens.,7,0,female_feminine,7,3456
5322,924845,common_voice_en_541206.mp3,The burning fire had been extinguished.,7,0,female_feminine,7,3504
5323,1239941,common_voice_en_30096287.mp3,She was affiliated with the University United Methodist Church.,7,0,female_feminine,7,6192
5324,538877,common_voice_en_59378.mp3,That sobered him a little.,8,1,female_feminine,7,2184
5325,566816,common_voice_en_53484.mp3,"I have known true alchemists, the alchemist continued.",8,1,female_feminine,7,5688
5326,601456,common_voice_en_589536.mp3,"At that point, the omens will tell you that your treasure is buried forever.",7,0,female_feminine,7,5544
5327,674698,common_voice_en_656353.mp3,"You don't have to be rich, skinny, popular, or even own a cape to perform a random act of kindness.",8,1,female_feminine,7,7920
5328,312005,common_voice_en_88171.mp3,"Sit down, and let me treat you to something, said the boy.",7,0,female_feminine,7,3456
5329,110372,common_voice_en_20285293.mp3,Nishi-Ward is the birthplace of pachinko.,7,0,female_feminine,7,4584
5330,407104,common_voice_en_46095.mp3,"Everything in the universe evolved, he said.",7,0,female_feminine,7,4416
5331,260487,common_voice_en_667632.mp3,"Looking through the telescope, I saw a circle of deep blue and the little round planet.",8,1,female_feminine,7,8832
5332,1150565,common_voice_en_26159.mp3,"Well, usually I learn more from my sheep than from books, he answered.",7,0,female_feminine,7,4536
5333,555077,common_voice_en_30282850.mp3,Smith particularly critiqued the injustices of war and property laws.,7,0,female_feminine,7,7380
5334,1150590,common_voice_en_26184.mp3,"I've never had one before, the merchant answered.",7,0,female_feminine,7,3312
5335,682990,common_voice_en_44663.mp3,"It was as if it quivered, but really this was the telescope vibrating.",8,1,female_feminine,7,5664
5336,1150584,common_voice_en_26178.mp3,You point to a trail of ants leading into the house.,7,0,female_feminine,7,3600
5337,1150583,common_voice_en_26177.mp3,"Everyone, when they are young, knows what their destiny is.",7,0,female_feminine,7,3840
5338,682985,common_voice_en_44658.mp3,An huge hole had been made by the impact of the projectile.,7,0,female_feminine,7,4464
5339,1150685,common_voice_en_26279.mp3,The boy listened quietly.,7,0,female_feminine,7,1968
5340,1150571,common_voice_en_26165.mp3,"Trust in your heart, but never forget that you're in the desert.",7,0,female_feminine,7,3264
5341,691228,common_voice_en_148805.mp3,Strange images passed through my mind.,7,0,female_feminine,7,3384
5342,557263,common_voice_en_608102.mp3,He was immensely excited at the news.,7,0,female_feminine,7,3624
5343,1150494,common_voice_en_26088.mp3,They never found the secret.,8,1,female_feminine,7,2160
5344,557275,common_voice_en_608115.mp3,"As I watched, the planet seemed to grow larger and smaller.",7,0,female_feminine,7,4056
5345,266232,common_voice_en_12827.mp3,"If I don't find it, I can always go home.",9,2,female_feminine,7,2904
5346,691189,common_voice_en_148766.mp3,"The heather was on fire, and you could see a thin blue smoke rising up slowly.",7,0,female_feminine,7,7728
5347,557271,common_voice_en_608111.mp3,I locked eyes with a fish in the tank.,9,2,female_feminine,7,3864
5348,675892,common_voice_en_656740.mp3,"Air was either entering or escaping at the rim with a thin, sizzling sound.",8,1,female_feminine,7,6624
5349,489340,common_voice_en_71785.mp3,"It was, however, still so hot from its flight through the air.",7,0,female_feminine,7,5208
5350,489345,common_voice_en_71790.mp3,But they were not there.,7,0,female_feminine,7,2784
5351,489347,common_voice_en_71792.mp3,A boy came running towards me.,8,1,female_feminine,7,2928
5352,264595,common_voice_en_86594.mp3,"About eleven, I walked back to my home in Maybury because nothing seemed to be happening.",7,0,female_feminine,7,9600
5353,1672009,common_voice_en_20286229.mp3,The second floor was guardrooms.,7,0,female_feminine,7,4320
5354,1150679,common_voice_en_26273.mp3,"It's the Emerald Tablet, said the Englishman, proud that he might teach something to the boy.",7,0,female_feminine,7,5016
5355,1672010,common_voice_en_20286230.mp3,"The first game in this series was based on the ""Dragon Quest"" series.",9,2,female_feminine,7,5328
5356,1672011,common_voice_en_20286231.mp3,His family were completely devastated.,7,0,female_feminine,7,4632
5357,742689,common_voice_en_693920.mp3,"Yet, it was a little too large for assurance.",7,0,female_feminine,7,4464
5358,418641,common_voice_en_59137.mp3,An huge hole had been made by the impact of the projectile.,7,0,female_feminine,7,2976
5359,1150670,common_voice_en_26264.mp3,The two walked out among the palms.,7,0,female_feminine,7,2760
5360,216009,common_voice_en_53436.mp3,We lit the lantern and walked over to his house.,7,0,female_feminine,7,3912
5361,1672006,common_voice_en_20286206.mp3,"Additionally, they are usually surrounded by a protective buffer zone called ""otulina"".",7,0,female_feminine,7,6768
5362,663824,common_voice_en_101118.mp3,"Besides that, there was a heap of bicycles.",7,0,female_feminine,7,4560
5363,1671985,common_voice_en_20286044.mp3,Jeffreys was an evangelist with a Welsh Congregational church background.,7,0,female_feminine,7,5784
5364,215178,common_voice_en_13531.mp3,Then came the night of the first falling star.,11,4,female_feminine,7,7560
5365,1150601,common_voice_en_26195.mp3,"He listened to the wind, and felt the stones beneath his feet.",7,0,female_feminine,7,3792
5366,1150609,common_voice_en_26203.mp3,A line of flame high can be seen in the atmosphere.,7,0,female_feminine,7,3480
5367,697250,common_voice_en_542473.mp3,"You should see the other guy, specifically, how good at fighting he is.",7,0,female_feminine,7,5496
5368,829059,common_voice_en_31199.mp3,"The nearby city of Ceuta had grown faster than Tangier, and business had fallen off.",7,0,female_feminine,7,8664
5369,663806,common_voice_en_101100.mp3,I'm going to them.,7,0,female_feminine,7,3336
5370,663803,common_voice_en_101097.mp3,Something inside the cylinder was unscrewing the top.,7,0,female_feminine,7,4440
5371,550146,common_voice_en_205965.mp3,A large piece suddenly came off and fell with a loud and sharp noise.,7,0,female_feminine,7,6216
5372,550179,common_voice_en_205998.mp3,"Among these people were a couple of cyclists, a gardener I employed sometimes, and a girl carrying a baby.",7,0,female_feminine,7,8232
5373,826847,common_voice_en_83725.mp3,But that was simply because my eye was tired.,7,0,female_feminine,7,2520
5374,663794,common_voice_en_101088.mp3,The thought was so dreadful to him that he forgot about the heat and went forward.,7,0,female_feminine,7,5472
5375,826822,common_voice_en_83693.mp3,I myself heard nothing of that.,7,0,female_feminine,7,1848
5376,826770,common_voice_en_83636.mp3,"If you start your emails with ""Greetings"" let me be the first to welcome you to Earth.",7,0,female_feminine,7,5712
5377,384593,common_voice_en_491406.mp3,That it was unable to deal with this boy who spoke the Language of the World.,7,0,female_feminine,7,6864
5378,663815,common_voice_en_101109.mp3,"My wife pointed out to me the brightness of the red, green, and yellow signal lights.",7,0,female_feminine,7,5784
5379,1150653,common_voice_en_26247.mp3,"I want to see him do it, said the chief.",7,0,female_feminine,7,2712
5380,773940,common_voice_en_692875.mp3,I was disappointed at this inanimate bulk.,7,0,female_feminine,7,3744
5381,394416,common_voice_en_18837.mp3,"As I watched, the planet seemed to grow larger and smaller.",8,1,female_feminine,7,4488
5382,1150491,common_voice_en_26085.mp3,The boy thought of Fatima.,7,0,female_feminine,7,2256
5383,945373,common_voice_en_37478229.mp3,Below are short entries on the organizations found at universities on a country-by-country basis.,7,0,female_feminine,7,7596
5384,394535,common_voice_en_17625060.mp3,What do you mean to do?,7,0,female_feminine,7,2784
5385,708756,common_voice_en_523053.mp3,"In spite of this, I still believed that there were men in Mars.",8,1,female_feminine,7,4464
5386,282511,common_voice_en_117657.mp3,I thought about the difficulties in translation that might arise.,10,3,female_feminine,7,5712
5387,995294,common_voice_en_48782.mp3,The people were also praying to heaven for protection.,7,0,female_feminine,7,3072
5388,1150378,common_voice_en_25972.mp3,The miner had abandoned everything to go mining for emeralds.,7,0,female_feminine,7,3696
5389,1150384,common_voice_en_25978.mp3,"At other times, at a crucial moment, I make it easier for things to happen.",7,0,female_feminine,7,4656
5390,1150389,common_voice_en_25983.mp3,"I'll be back, the boy said.",7,0,female_feminine,7,2136
5391,1150410,common_voice_en_26004.mp3,He took his money from his pouch and showed it to the young man.,7,0,female_feminine,7,3408
5392,1150550,common_voice_en_26144.mp3,He remembered what the old man had said about offering something you didn't even have yet.,7,0,female_feminine,7,5040
5393,1150420,common_voice_en_26014.mp3,"So, then try, he said to the Englishman.",7,0,female_feminine,7,3576
5394,1150466,common_voice_en_26060.mp3,"I had a dream, and I met with a king.",7,0,female_feminine,7,2976
5395,1150462,common_voice_en_26056.mp3,He took back his books and packed them away again in their bags.,7,0,female_feminine,7,3720
5396,1150435,common_voice_en_26029.mp3,And he gave the boy his blessing.,7,0,female_feminine,7,2328
5397,277300,common_voice_en_138995.mp3,"I can work for the rest of today, the boy answered.",7,0,female_feminine,7,5280
5398,1150476,common_voice_en_26070.mp3,"You are almost at the end of your journey, said the alchemist.",8,1,female_feminine,7,4008
5399,1150478,common_voice_en_26072.mp3,"The girl dropped the container, and the water spilled.",7,0,female_feminine,7,3456
5400,1150449,common_voice_en_26043.mp3,People continued to come and go from the baker's shop.,7,0,female_feminine,7,3384
5401,1150450,common_voice_en_26044.mp3,We lit the lantern and walked over to his house.,9,2,female_feminine,7,2832
5402,1150453,common_voice_en_26047.mp3,"I left my father, my mother, and the town castle behind.",7,0,female_feminine,7,4104
5403,570350,common_voice_en_132244.mp3,But now the sounds inside had stopped.,8,1,female_feminine,7,4392
5404,1150457,common_voice_en_26051.mp3,"I'm not hiding anything, the boy answered.",7,0,female_feminine,7,2760
5405,1150416,common_voice_en_26010.mp3,I just know that the Tradition is always right.,8,1,female_feminine,7,3240
5406,489356,common_voice_en_71801.mp3,Few people realise the immensity of vacancy.,8,1,female_feminine,7,4536
5407,489357,common_voice_en_71802.mp3,They set off running wildly into the trees.,7,0,female_feminine,7,3384
5408,489359,common_voice_en_71804.mp3,"Air was either entering or escaping at the rim with a thin, sizzling sound.",7,0,female_feminine,7,6264
5409,682958,common_voice_en_44631.mp3,My mind ran on the possibilities of its content.,8,1,female_feminine,7,4584
5410,1150538,common_voice_en_26132.mp3,"Ask the owner of that stall how much the sword costs, he said to his friend.",7,0,female_feminine,7,4248
5411,310605,common_voice_en_508380.mp3,A large portion of the cylinder had been uncovered.,7,0,female_feminine,7,4224
5412,637826,common_voice_en_62488.mp3,"He moved about, invisible but everyone could hear him.",7,0,female_feminine,7,4512
5413,490309,common_voice_en_637245.mp3,The night was warm and I was thirsty.,7,0,female_feminine,7,4320
5414,797869,common_voice_en_607079.mp3,The end of the cylinder was still as Ogilvy and Henderson had left it.,7,0,female_feminine,7,6048
5415,682945,common_voice_en_44618.mp3,Some of the grey ash was falling off the circular edge.,8,1,female_feminine,7,4776
5416,1150532,common_voice_en_26126.mp3,"They didn't have the printing press in those days, the boy argued.",7,0,female_feminine,7,3384
5417,1150529,common_voice_en_26123.mp3,"An old man, with a breastplate of gold, wouldn't have lied just to acquire six sheep.",7,0,female_feminine,7,4752
5418,394479,common_voice_en_49214.mp3,But that was simply because my eye was tired.,8,1,female_feminine,7,4104
5419,1150519,common_voice_en_26113.mp3,"In those days, very few of the people had any idea about astronomy.",7,0,female_feminine,7,4248
5420,375893,common_voice_en_37641.mp3,They shouted consolation and promises and went off back to the town again to get help.,7,0,female_feminine,7,7416
5421,375894,common_voice_en_37642.mp3,"I pointed out Mars, a bright dot of light.",7,0,female_feminine,7,5184
5422,682931,common_voice_en_44604.mp3,But I didn’t think that it contained any living creature.,7,0,female_feminine,7,5088
5423,375896,common_voice_en_37644.mp3,It left a greenish streak that glowed for some seconds.,8,1,female_feminine,7,6720
5424,375899,common_voice_en_37647.mp3,I'm going to them.,7,0,female_feminine,7,2592
5425,375903,common_voice_en_37651.mp3,And then he perceived it very slowly.,7,0,female_feminine,7,4344
5426,564525,common_voice_en_186212.mp3,"The desert, with its endless monotony, put him to dreaming.",7,0,female_feminine,7,6984
5427,697224,common_voice_en_542443.mp3,But they were not there.,7,0,female_feminine,7,2112
5428,708706,common_voice_en_523002.mp3,It had a diameter of about thirty yards.,7,0,female_feminine,7,2616
5429,1150496,common_voice_en_26090.mp3,"It's true that everything has its destiny, but one day that destiny will be realized.",7,0,female_feminine,7,4968
5430,394471,common_voice_en_49206.mp3,The thought was so dreadful to him that he forgot about the heat and went forward.,8,1,female_feminine,7,6024
5431,1150525,common_voice_en_26119.mp3,Butmaybe I'll never have another chance to get to the Pyramids in Egypt.,7,0,female_feminine,7,4104
5432,697229,common_voice_en_542448.mp3,It had a diameter of about thirty yards.,7,0,female_feminine,7,3480
5433,863925,common_voice_en_683199.mp3,I thought about the difficulties in translation that might arise.,7,0,female_feminine,7,3936
5434,711806,common_voice_en_42041.mp3,It sounded like a Gypsy prayer.,7,0,female_feminine,7,3912
5435,894888,common_voice_en_536334.mp3,"Besides that, there was a heap of bicycles.",7,0,female_feminine,7,3768
5436,711835,common_voice_en_42070.mp3,"After all, he had all his money.",7,0,female_feminine,7,3696
5437,711816,common_voice_en_42051.mp3,"But if you have to go before then, go on in pursuit of your dream.",7,0,female_feminine,7,5928
5438,567286,common_voice_en_83146.mp3,He noticed the unequal cooling of its surface.,7,0,female_feminine,7,2712
5439,1150674,common_voice_en_26268.mp3,So you won't blame her.,7,0,female_feminine,7,2328
5440,711807,common_voice_en_42042.mp3,You'll be the counselor of the oasis.,7,0,female_feminine,7,5256
5441,663965,common_voice_en_75802.mp3,"You have helped me. The man continued to prepare his tea, saying nothing.",7,0,female_feminine,7,3984
5442,450576,common_voice_en_35209.mp3,"Having heard that, the boy became even more interested in alchemy.",8,1,female_feminine,7,3840
5443,711836,common_voice_en_42071.mp3,It made me very depressed.,7,0,female_feminine,7,4224
5444,894792,common_voice_en_536230.mp3,It had a diameter of about thirty yards.,7,0,female_feminine,7,3792
5445,711839,common_voice_en_42074.mp3,"The old man gave a signal, and everyone stood.",7,0,female_feminine,7,4968
5446,711820,common_voice_en_42055.mp3,The idea frightened him.,7,0,female_feminine,7,3864
5447,711819,common_voice_en_42054.mp3,"Well then, help me do that, the boy said.",7,0,female_feminine,7,4536
5448,368981,common_voice_en_22003164.mp3,yes,7,0,female_feminine,7,2424
5449,664001,common_voice_en_75840.mp3,"I can clean up those glasses in the window, if you want, said the boy.",7,0,female_feminine,7,3792
5450,840406,common_voice_en_678184.mp3,'m all about those invisible cosmic connections that transcend time and distance.,7,0,female_feminine,7,5664
5451,449493,common_voice_en_645240.mp3,"If you start your emails with ""Greetings"" let me be the first to welcome you to Earth.",7,0,female_feminine,7,9912
5452,894872,common_voice_en_536317.mp3,"My wife pointed out to me the brightness of the red, green, and yellow signal lights.",7,0,female_feminine,7,5448
5453,711838,common_voice_en_42073.mp3,"Everything in life is an omen, said the Englishman, now closing the journal he was reading.",8,1,female_feminine,7,8040
5454,450584,common_voice_en_35219.mp3,Camels are traitorous: they walk thousands of paces and never seem to tire.,8,1,female_feminine,7,4824
5455,1065843,common_voice_en_18169748.mp3,We have it scheduled for August first.,7,0,female_feminine,7,3648
5456,711802,common_voice_en_42037.mp3,To continue his search for the treasure meant that he had to abandon Fatima.,8,1,female_feminine,7,6936
5457,711861,common_voice_en_42096.mp3,"The boy fell to the sand, nearly unconscious.",7,0,female_feminine,7,4944
5458,577960,common_voice_en_17354012.mp3,"Christine valued her freedom, and would never deny anyone that privilege.",7,0,female_feminine,7,6336
5459,1150659,common_voice_en_26253.mp3,I thought the unscrewing might be automatic.,7,0,female_feminine,7,3000
5460,711845,common_voice_en_42080.mp3,"The level ground was blackened as far as one could see, and it was still giving off smoke.",7,0,female_feminine,7,7416
5461,691225,common_voice_en_148802.mp3,The two men hurried back and found the cylinder still lying in the same position.,7,0,female_feminine,7,9384
5462,567274,common_voice_en_83134.mp3,But they were not there.,7,0,female_feminine,7,2136
5463,182845,common_voice_en_96259.mp3,But everything had changed.,7,0,female_feminine,7,2760
5464,1672029,common_voice_en_20286398.mp3,Under Barnes they have appeared multiple times in the Final Four and Championship Game.,7,0,female_feminine,7,7128
5465,182843,common_voice_en_96249.mp3,The woman was silent for some time.,7,0,female_feminine,7,3192
5466,450577,common_voice_en_35210.mp3,"If I don't find it, I can always go home.",7,0,female_feminine,7,3720
5467,863873,common_voice_en_683141.mp3,My mind ran on the possibilities of its content.,7,0,female_feminine,7,4344
5468,640139,common_voice_en_645631.mp3,"The level ground was blackened as far as one could see, and it was still giving off smoke.",6,0,female_feminine,6,6192
5469,1660923,common_voice_en_37972997.mp3,The discipline may be practiced recreationally or as a competitive sport.,6,0,female_feminine,6,6948
5470,1660921,common_voice_en_37972978.mp3,Very soon the conversation drifted to his own doings.,6,0,female_feminine,6,5328
5471,219015,common_voice_en_10047.mp3,"In some places, the ground was covered with the salt of dried-up lakes.",6,0,female_feminine,6,7224
5472,1150486,common_voice_en_26080.mp3,He understands the forces of nature.,7,1,female_feminine,6,2712
5473,455636,common_voice_en_60580.mp3,"The war continued, and at times the wind carried the sweet, sickly smell of blood.",6,0,female_feminine,6,6696
5474,928597,common_voice_en_31804240.mp3,Making it likely to be retained in the nucleus after transcription.,6,0,female_feminine,6,4968
5475,637794,common_voice_en_62456.mp3,It was dropping off in flakes and raining down on the sand.,6,0,female_feminine,6,5784
5476,928643,common_voice_en_31818333.mp3,He collected all the history and literary works which he deemed necessary.,6,0,female_feminine,6,4716
5477,1660954,common_voice_en_37974789.mp3,There are two legislative districts in the city.,6,0,female_feminine,6,5220
5478,928636,common_voice_en_31818310.mp3,Good performances and some nice technical output help.,6,0,female_feminine,6,4248
5479,456969,common_voice_en_137743.mp3,Hundreds of observers saw the flame that night and the night after.,6,0,female_feminine,6,5328
5480,450580,common_voice_en_35214.mp3,I told you that your dream was a difficult one.,7,1,female_feminine,6,2832
5481,456961,common_voice_en_137733.mp3,Everyone seemed very excited.,6,0,female_feminine,6,2640
5482,1479572,common_voice_en_34963889.mp3,Two young men hope to control their wives after their respective marriages.,6,0,female_feminine,6,5004
5483,957243,common_voice_en_33010671.mp3,It was also used in performance.,6,0,female_feminine,6,4500
5484,928562,common_voice_en_31499541.mp3,The design emphasizes power efficiency.,6,0,female_feminine,6,3708
5485,456955,common_voice_en_137726.mp3,"My seven year resume gap is marked ""Not Drugs"".",6,0,female_feminine,6,5616
5486,1479394,common_voice_en_34962567.mp3,Caesar knew the Marx Brothers during his childhood.,6,0,female_feminine,6,3780
5487,768538,common_voice_en_169485.mp3,Ogilvy told him everything that he had seen.,6,0,female_feminine,6,5112
5488,1150480,common_voice_en_26074.mp3,He knew he was stronger than his friend.,6,0,female_feminine,6,2520
5489,768528,common_voice_en_169475.mp3,"Many people in Berkshire, Surrey, and Middlesex must have seen it.",6,0,female_feminine,6,4224
5490,995300,common_voice_en_48789.mp3,"The alchemist dismounted, and told the escorts they could return to the camp.",6,0,female_feminine,6,5808
5491,836412,common_voice_en_35121359.mp3,Beef and dairy cattle are kept in the province.,6,0,female_feminine,6,3888
5492,1479591,common_voice_en_34963942.mp3,This led to its abandonment by at least one former proponent.,6,0,female_feminine,6,4428
5493,1322374,common_voice_en_38770449.mp3,We just happened to be recording that song.,6,0,female_feminine,6,4248
5494,1150483,common_voice_en_26077.mp3,That doesn't happen to just anyone!,6,0,female_feminine,6,2760
5495,456957,common_voice_en_137728.mp3,"I had the ""everyone has Gary Busey's teeth"" dream again.",6,0,female_feminine,6,5304
5496,883848,common_voice_en_33342202.mp3,At least one maid took care of the house and garden services.,6,0,female_feminine,6,5940
5497,455492,common_voice_en_37489755.mp3,There is a public park located in the heart of town.,6,0,female_feminine,6,3060
5498,883849,common_voice_en_33342203.mp3,Wilcocks was educated at the University of Oxford.,6,0,female_feminine,6,5760
5499,883850,common_voice_en_33342204.mp3,Several of the alumni would distinguish themselves on the contemporary Swedish visual arts scene.,6,0,female_feminine,6,7776
5500,883851,common_voice_en_33342205.mp3,"He was editor of ""The Vegetarian Messenger and Health Review"".",6,0,female_feminine,6,5328
5501,711833,common_voice_en_42068.mp3,"The boy waited, and then interrupted the old man just as he himself had been interrupted.",6,0,female_feminine,6,6768
5502,773986,common_voice_en_692922.mp3,"You don't have to be rich, skinny, popular, or even own a cape to perform a random act of kindness.",6,0,female_feminine,6,8424
5503,737471,common_voice_en_31388625.mp3,The marinades and spice blends are both made in house.,6,0,female_feminine,6,4680
5504,445357,common_voice_en_630460.mp3,"As I watched, the planet seemed to grow larger and smaller.",6,0,female_feminine,6,4584
5505,883854,common_voice_en_33342251.mp3,"He was named player of the year by the ""Los Angeles Times"".",6,0,female_feminine,6,5580
5506,637805,common_voice_en_62467.mp3,It had a diameter of about thirty yards.,7,1,female_feminine,6,3552
5507,1150503,common_voice_en_26097.mp3,"The alchemists spent years in their laboratories, observing the fire that purified the metals.",6,0,female_feminine,6,5208
5508,883855,common_voice_en_33342253.mp3,He also played for the Frankfurt Galaxy.,6,0,female_feminine,6,5148
5509,450575,common_voice_en_35208.mp3,He took his money from his pouch and showed it to the young man.,6,0,female_feminine,6,3504
5510,883967,common_voice_en_36481383.mp3,It also has an office in Mecca.,6,0,female_feminine,6,4716
5511,883966,common_voice_en_36481382.mp3,"He teaches English literature and creative writing at Royal Holloway, University of London.",6,0,female_feminine,6,7560
5512,957168,common_voice_en_33010382.mp3,It was the first company to commercialize phonebooths and sell them internationally.,6,0,female_feminine,6,6876
5513,883965,common_voice_en_36481381.mp3,"When Sadi Carnot endorsed electoral candidates, he often identified them as such attendees.",6,0,female_feminine,6,8748
5514,1150498,common_voice_en_26092.mp3,"And to do that, you need money.",6,0,female_feminine,6,2376
5515,450578,common_voice_en_35211.mp3,"You'll marry Fatima, and you'll both be happy for a year.",7,1,female_feminine,6,3864
5516,1322284,common_voice_en_38724601.mp3,"The Restatement Standard opens up their liability to named ""classes"" of individuals.",6,0,female_feminine,6,9720
5517,708740,common_voice_en_523037.mp3,Most of them were staring quietly at the big table.,6,0,female_feminine,6,3240
5518,442023,common_voice_en_173848.mp3,"At that time, it was quite clear in my own mind that the thing had come from the planet Mars.",6,0,female_feminine,6,6024
5519,708737,common_voice_en_523034.mp3,"We don't know what's in the confounded thing, do you?",6,0,female_feminine,6,3024
5520,928551,common_voice_en_31499510.mp3,She won the Republican primary against three other candidates.,6,0,female_feminine,6,4968
5521,455641,common_voice_en_60585.mp3,We always observe the Tradition.,6,0,female_feminine,6,3312
5522,737478,common_voice_en_31388655.mp3,The proposal took inspiration from the mangrove trees located on the channel.,6,0,female_feminine,6,5040
5523,883847,common_voice_en_33342201.mp3,It has been found to increase luteinizing hormone levels in premenopausal women.,6,0,female_feminine,6,7236
5524,883856,common_voice_en_33342254.mp3,There is no automatic promotion to the British National League from the English League.,6,0,female_feminine,6,6948
5525,928527,common_voice_en_31499399.mp3,The delegates were far ahead of their time in what they proposed.,6,0,female_feminine,6,4608
5526,711837,common_voice_en_42072.mp3,But you are in the desert.,6,0,female_feminine,6,4320
5527,839006,common_voice_en_101476.mp3,"So he could not be hasty, nor impatient.",6,0,female_feminine,6,5184
5528,1658176,common_voice_en_37928149.mp3,She practices in Paris.,6,0,female_feminine,6,3348
5529,1660897,common_voice_en_37972784.mp3,He stands trial for the murder and serves time in an English jail.,6,0,female_feminine,6,6516
5530,883872,common_voice_en_33342764.mp3,After marrying she moved to Kuwana in Mie Prefecture.,6,0,female_feminine,6,5436
5531,1619592,common_voice_en_27191064.mp3,He performs solo on the electric guitar.,7,1,female_feminine,6,3816
5532,883585,common_voice_en_660377.mp3,The time must have been somewhere around six o'clock.,6,0,female_feminine,6,4224
5533,883564,common_voice_en_660355.mp3,And then he perceived it very slowly.,6,0,female_feminine,6,3888
5534,461377,common_voice_en_30694366.mp3,Carlos Abril Miami edu,6,0,female_feminine,6,4536
5535,981382,common_voice_en_37506018.mp3,This is achieved through the use of a wavelength selective switching module.,6,0,female_feminine,6,5400
5536,1663111,common_voice_en_38013702.mp3,"However, these people were not prevented from voting by the Act.",6,0,female_feminine,6,6048
5537,1150479,common_voice_en_26073.mp3,"He wanted your money, he said.",6,0,female_feminine,6,2448
5538,1479282,common_voice_en_34944739.mp3,The condition is left-right symmetric.,6,0,female_feminine,6,3348
5539,182784,common_voice_en_38800071.mp3,Later the Progressive Party was also added.,6,0,female_feminine,6,3960
5540,156903,common_voice_en_42578.mp3,"An hour later, he had before him a chest of Spanish gold coins.",6,0,female_feminine,6,6576
5541,1479267,common_voice_en_34944683.mp3,Molecular phylogenetic analyses are providing new information about relationships between chanterelle populations.,6,0,female_feminine,6,8316
5542,1150477,common_voice_en_26071.mp3,The Emerald Tablet is a direct passage to the Soul of the World.,6,0,female_feminine,6,4080
5543,167035,common_voice_en_17558533.mp3,"By accepting our privacy policy, you agree that we save your data for twenty-one days to detect frauds.",6,0,female_feminine,6,9720
5544,1277559,common_voice_en_38026455.mp3,The original Zenda High School mascot was Zenda Gorillas.,6,0,female_feminine,6,4536
5545,1150442,common_voice_en_26036.mp3,"The horseman was completely immobile, as was the boy.",6,0,female_feminine,6,3696
5546,1479269,common_voice_en_34944687.mp3,Tubb always surrounded himself with some of Nashville's best musicians.,6,0,female_feminine,6,4896
5547,1479303,common_voice_en_34956443.mp3,The following text was derived from old Mission records.,8,2,female_feminine,6,4824
5548,156789,common_voice_en_524801.mp3,They shouted consolation and promises and went off back to the town again to get help.,6,0,female_feminine,6,6480
5549,156906,common_voice_en_42581.mp3,"It's the other foreigner, the Englishman.",6,0,female_feminine,6,3744
5550,1277606,common_voice_en_38039398.mp3,The reduction in pressure drag causes the ball to travel farther.,6,0,female_feminine,6,4680
5551,704998,common_voice_en_32274264.mp3,Some students may not have access to the proper technology and internet access.,6,0,female_feminine,6,6228
5552,704986,common_voice_en_32274250.mp3,He studied painting at the Accademia di San Luca in Rome.,6,0,female_feminine,6,6480
5553,963209,common_voice_en_32917102.mp3,Its leaves are obtuse and its bracts are covered in white.,6,0,female_feminine,6,5040
5554,182785,common_voice_en_38800072.mp3,Glaucus replies: Hippolochus begat me.,6,0,female_feminine,6,4896
5555,711853,common_voice_en_42088.mp3,The boy went to look for the Englishman.,6,0,female_feminine,6,4488
5556,463565,common_voice_en_2644.mp3,No more we live like pigs in the field.,6,0,female_feminine,6,3744
5557,463564,common_voice_en_2643.mp3,But where are the houses?,6,0,female_feminine,6,2760
5558,1660815,common_voice_en_37970521.mp3,Elements are presented in order of increasing atomic number.,6,0,female_feminine,6,6336
5559,463558,common_voice_en_2637.mp3,I didn't do nothing.,6,0,female_feminine,6,2208
5560,1658765,common_voice_en_37935447.mp3,The Ford Galaxy was reviewed by What Car?,6,0,female_feminine,6,5256
5561,1479216,common_voice_en_34944511.mp3,The Educational Department holds inter-school competitions in different subjects.,6,0,female_feminine,6,5364
5562,1479227,common_voice_en_34944565.mp3,See A complete history of the Light Station and Ecological Reserve.,6,0,female_feminine,6,5292
5563,1479228,common_voice_en_34944566.mp3,He fully recovered after an operation in Switzerland for treatment.,6,0,female_feminine,6,4680
5564,1150452,common_voice_en_26046.mp3,"It was a cobra, whose venom could kill a person in minutes.",6,0,female_feminine,6,3624
5565,154779,common_voice_en_31282733.mp3,He was the greatest paratrooper of them all.,6,0,female_feminine,6,5616
5566,711850,common_voice_en_42085.mp3,The boy began to dig into the dune.,6,0,female_feminine,6,4464
5567,462649,common_voice_en_527839.mp3,"Many people in Berkshire, Surrey, and Middlesex must have seen it.",6,0,female_feminine,6,6168
5568,1479221,common_voice_en_34944534.mp3,The school features unique programs such as the Wetlands Estonoa Project.,6,0,female_feminine,6,5400
5569,1479261,common_voice_en_34944658.mp3,Jandakot Airport serves pilot testing and domestic plane flights.,6,0,female_feminine,6,5256
5570,182783,common_voice_en_38800070.mp3,"He was born in Truro, Cornwall.",6,0,female_feminine,6,3816
5571,1277507,common_voice_en_38015739.mp3,Their language became extinct.,6,0,female_feminine,6,2700
5572,981371,common_voice_en_37506006.mp3,Benito plays in The Jealous Sound while James Tweedy played in The Bronx.,6,0,female_feminine,6,5976
5573,461392,common_voice_en_30694402.mp3,She identifies love with the flowers that give the work its title.,6,0,female_feminine,6,5328
5574,154775,common_voice_en_30958258.mp3,Inscriptions appear painted on the inside or carved into the cross.,6,0,female_feminine,6,6372
5575,154778,common_voice_en_31282732.mp3,This motion was decided against.,6,0,female_feminine,6,3204
5576,981318,common_voice_en_37465566.mp3,A river or stream may remain in the valley.,6,0,female_feminine,6,3816
5577,1150392,common_voice_en_25986.mp3,I am following my destiny.,6,0,female_feminine,6,2304
5578,1277697,common_voice_en_38041749.mp3,The Commission was chaired by Aiken Watson.,8,2,female_feminine,6,3528
5579,1150390,common_voice_en_25984.mp3,"He had found where his treasure was, and was frightened at what might happen.",7,1,female_feminine,6,3792
5580,963190,common_voice_en_32916389.mp3,After his death it was named in his honor by his son John Wragg.,6,0,female_feminine,6,4176
5581,165227,common_voice_en_510630.mp3,Then the thing came upon him in a flash.,6,0,female_feminine,6,3816
5582,1322701,common_voice_en_38856504.mp3,But it's crucial to stay the course.,10,4,female_feminine,6,4140
5583,1371264,common_voice_en_38081242.mp3,"Other risk factors include radiation therapy, chemotherapy, and organ transplantation.",6,0,female_feminine,6,7920
5584,450591,common_voice_en_35226.mp3,The old man returned the book to the boy.,6,0,female_feminine,6,2736
5585,963133,common_voice_en_32916219.mp3,It can also be found on the Marshall Islands and the Mariana Islands.,6,0,female_feminine,6,4788
5586,1656726,common_voice_en_37886946.mp3,"When a cockroach moults, it will appear pure white except for the eyes.",6,0,female_feminine,6,6840
5587,1150434,common_voice_en_26028.mp3,"Death doesn't change anything, the boy thought.",6,0,female_feminine,6,3192
5588,450589,common_voice_en_35224.mp3,"When I first reached through to it, I thought the Soul of the World was perfect.",8,2,female_feminine,6,3984
5589,457425,common_voice_en_31941084.mp3,He ran for Congress once but was defeated.,6,0,female_feminine,6,3708
5590,883888,common_voice_en_33342852.mp3,Flowers are bright red and bright white in color with gold stamens.,6,0,female_feminine,6,5796
5591,1322576,common_voice_en_38835033.mp3,"He also won scriptwriting awards for ""Fallout"" and for ""View from the Top"".",6,0,female_feminine,6,5688
5592,1322572,common_voice_en_38834846.mp3,This is the form that allows him to release his full potential.,6,0,female_feminine,6,6048
5593,928647,common_voice_en_31818337.mp3,Four additional songs were cut during the same January sessions.,6,0,female_feminine,6,4356
5594,711846,common_voice_en_42081.mp3,The Englishman was disappointed.,6,0,female_feminine,6,3864
5595,457272,common_voice_en_598982.mp3,All that time the Martians must have been getting ready.,6,0,female_feminine,6,4104
5596,457270,common_voice_en_598980.mp3,We lit the lantern and walked over to his house.,6,0,female_feminine,6,5280
5597,445341,common_voice_en_630443.mp3,My review of the sun: one star.,6,0,female_feminine,6,3552
5598,1150387,common_voice_en_25981.mp3,"I'm going to find that damned alchemist, the Englishman thought.",7,1,female_feminine,6,3480
5599,637792,common_voice_en_62454.mp3,My review of the sun: one star.,6,0,female_feminine,6,3624
5600,159889,common_voice_en_19194.mp3,It was only when I got this close to it that the strangeness of it was at all evident to me.,7,1,female_feminine,6,5832
5601,1150425,common_voice_en_26019.mp3,"I was scared, but wasted no time in going out and crossing the bridge to the sand pits.",6,0,female_feminine,6,4608
5602,1150424,common_voice_en_26018.mp3,Now it will be with hope.,6,0,female_feminine,6,2688
5603,1656680,common_voice_en_37886235.mp3,"Others left the country, commonly moving to Canada.",6,0,female_feminine,6,5688
5604,704979,common_voice_en_32274243.mp3,Will attempts to endear himself to Mr Gilbert despite his constant animosity towards him.,6,0,female_feminine,6,6768
5605,160375,common_voice_en_39794238.mp3,He is only featured as a background character.,6,0,female_feminine,6,4176
5606,1150446,common_voice_en_26040.mp3,It had a diameter of about thirty yards.,6,0,female_feminine,6,3264
5607,160376,common_voice_en_39794239.mp3,There is a pair of small craters along the northwestern inner wall.,6,0,female_feminine,6,6696
5608,1371169,common_voice_en_38080468.mp3,He was completed music education from Dhaka International Music School.,6,0,female_feminine,6,6588
5609,1150398,common_voice_en_25992.mp3,I thought that everything I owned would be destroyed.,6,0,female_feminine,6,3072
5610,1150444,common_voice_en_26038.mp3,But his heart was speaking of other things.,7,1,female_feminine,6,2664
5611,995288,common_voice_en_48775.mp3,"From then on, he would make his own decisions.",6,0,female_feminine,6,3048
5612,1277666,common_voice_en_38041662.mp3,There she made the New Mexico Lobos football team as a walk-on placekicker.,6,0,female_feminine,6,5400
5613,1150411,common_voice_en_26005.mp3,"I'm an adventurer, looking for treasure, he said to himself.",6,0,female_feminine,6,3744
5614,184088,common_voice_en_32351426.mp3,This molding process allows to manufacture circular parts.,6,0,female_feminine,6,7056
5615,1150469,common_voice_en_26063.mp3,Maybe that's why they always stay close to me.,6,0,female_feminine,6,3048
5616,1659602,common_voice_en_37951797.mp3,There are different dates for different year students.,6,0,female_feminine,6,4680
5617,1150407,common_voice_en_26001.mp3,"It's too bad that he's quickly going to forget my name, he thought.",6,0,female_feminine,6,3672
5618,1150402,common_voice_en_25996.mp3,"As the Englishman left, Fatima arrived and filled her vessel with water.",7,1,female_feminine,6,4104
5619,1150401,common_voice_en_25995.mp3,He had come to the town only to find a woman who could interpret his dream.,6,0,female_feminine,6,4248
5620,1479346,common_voice_en_34961859.mp3,"It has been described as a ""rustic free-form version of an open fruit tart"".",6,0,female_feminine,6,5688
5621,1150613,common_voice_en_26207.mp3,"Next morning, there were two thousand armed men scattered throughout the palm trees at Al- Fayoum.",6,0,female_feminine,6,5520
5622,883942,common_voice_en_35051800.mp3,"The cape is rocky, steep and mostly composed of limestone.",6,0,female_feminine,6,5868
5623,883908,common_voice_en_34983080.mp3,Some of the most enthusiastic crowds can be found at these games.,6,0,female_feminine,6,6768
5624,637827,common_voice_en_62489.mp3,It seemed so safe and tranquil.,6,0,female_feminine,6,3144
5625,883941,common_voice_en_35051799.mp3,"On the other side, the beneficiaries of the trade obtain a superprofit.",6,0,female_feminine,6,5940
5626,883911,common_voice_en_34983103.mp3,"The street is now called Watterson Street, and the house was taken down.",6,0,female_feminine,6,6120
5627,883912,common_voice_en_34983104.mp3,She is committed to responsible leadership and sustainable impact.,6,0,female_feminine,6,6156
5628,1657623,common_voice_en_37913021.mp3,He was born at Lucca.,6,0,female_feminine,6,3240
5629,883914,common_voice_en_34983106.mp3,"Cybernetics and holographic projections as depicted in ""RoboCop"" and ""I, Robot"" are also popularized.",6,0,female_feminine,6,10116
5630,207061,common_voice_en_128517.mp3,They had gone away to breakfast at Henderson's house.,6,0,female_feminine,6,5184
5631,178405,common_voice_en_34294862.mp3,Maccabi Tel Aviv were the defending champions.,6,0,female_feminine,6,5976
5632,216016,common_voice_en_53443.mp3,The loafers and golf caddies were used to hanging out near the railway station.,6,0,female_feminine,6,5544
5633,178406,common_voice_en_34294863.mp3,The title denotes the sound of buzzing honey bees.,6,0,female_feminine,6,4680
5634,178407,common_voice_en_34294865.mp3,His broad knowledge of Shas and poskim was well known.,6,0,female_feminine,6,5976
5635,178408,common_voice_en_34294866.mp3,It was during this time that she first started publishing poetry.,6,0,female_feminine,6,5436
5636,1150631,common_voice_en_26225.mp3,"What is an alchemist? he asked, finally.",6,0,female_feminine,6,3672
5637,883939,common_voice_en_35051778.mp3,This was enough to win the Olympic bronze medal.,6,0,female_feminine,6,4680
5638,178409,common_voice_en_34294889.mp3,This is named after nationalist politician and educationist Doctor Anugrah Narayan Sinha.,6,0,female_feminine,6,8100
5639,1150634,common_voice_en_26228.mp3,The oasis is neutral ground.,6,0,female_feminine,6,2496
5640,220092,common_voice_en_653378.mp3,I got drunk yesterday and thought I built a super computer.,6,0,female_feminine,6,4296
5641,883894,common_voice_en_33342888.mp3,This was accompanied by economic impoverishment for the sisters.,6,0,female_feminine,6,5400
5642,711799,common_voice_en_42034.mp3,"And he asked the boy if he, too, were in search of the alchemist.",6,0,female_feminine,6,4776
5643,883900,common_voice_en_34983014.mp3,"Abel was born in Plattsmouth, Nebraska, the daughter of Charles Hempel and Ella Hempel.",6,0,female_feminine,6,7380
5644,1657761,common_voice_en_37913947.mp3,He looked at his own hand.,8,2,female_feminine,6,3420
5645,1660862,common_voice_en_37970826.mp3,I have nothing about me by which I can be recognized.,6,0,female_feminine,6,5400
5646,883902,common_voice_en_34983016.mp3,"This process is also called ""reduction of complexity"".",6,0,female_feminine,6,5220
5647,454589,common_voice_en_60066.mp3,"Well then, help me do that, the boy said.",6,0,female_feminine,6,3888
5648,883944,common_voice_en_35051802.mp3,He is an alumnus of The University of Oklahoma.,6,0,female_feminine,6,4896
5649,178411,common_voice_en_34294892.mp3,This was not to say that the album had no weaknesses.,6,0,female_feminine,6,5688
5650,883943,common_voice_en_35051801.mp3,"Her novel ""The Porcelain Dove"" won the Mythopoeic Fantasy Award.",6,0,female_feminine,6,7128
5651,883904,common_voice_en_34983018.mp3,’Twill be as easy as stealing milk from a kitten.,6,0,female_feminine,6,4680
5652,840376,common_voice_en_678154.mp3,I locked eyes with a fish in the tank.,6,0,female_feminine,6,4680
5653,216595,common_voice_en_503624.mp3,But I found it difficult to get to work because of the investigations.,6,0,female_feminine,6,6024
5654,1150600,common_voice_en_26194.mp3,The problem is that they don't even realize that they're walking a new road every day.,6,0,female_feminine,6,4800
5655,438114,common_voice_en_57006.mp3,The time must have been somewhere around six o'clock.,7,1,female_feminine,6,5544
5656,883906,common_voice_en_34983078.mp3,"A small schooling fish, ""Knightia"" made an abundant food source for larger Eocene predators.",6,0,female_feminine,6,8280
5657,1662599,common_voice_en_38005332.mp3,The idea of opening her own workshop appears more and more attractive.,6,0,female_feminine,6,6876
5658,1150577,common_voice_en_26171.mp3,He decided to stay right there and await his return.,6,0,female_feminine,6,2952
5659,1150579,common_voice_en_26173.mp3,"A shepherd may like to travel, but he should never forget about his sheep.",6,0,female_feminine,6,4416
5660,883907,common_voice_en_34983079.mp3,The production also won the Tony Award for Best Revival of a Play.,6,0,female_feminine,6,5868
5661,883903,common_voice_en_34983017.mp3,This prompted the Daily Mail to run a nationwide village sign competition.,6,0,female_feminine,6,6480
5662,438099,common_voice_en_56991.mp3,"In those days, very few of the people had any idea about astronomy.",7,1,female_feminine,6,5784
5663,883932,common_voice_en_35051724.mp3,Heart Lake gets its name from its very distinct heart like shape.,6,0,female_feminine,6,5436
5664,883921,common_voice_en_35051710.mp3,Her Cadillac Eldorado was also missing.,6,0,female_feminine,6,4428
5665,215744,common_voice_en_36391298.mp3,The highway then enters some mountainous terrain before crossing into Campbell County.,6,0,female_feminine,6,7164
5666,1150643,common_voice_en_26237.mp3,The boy was becoming nervous.,6,0,female_feminine,6,2136
5667,215746,common_voice_en_36391300.mp3,"We create entertainment, and it's not really just that we can aggregate an audience.",6,0,female_feminine,6,6696
5668,1150677,common_voice_en_26271.mp3,Where is the treasure? he asked.,6,0,female_feminine,6,2544
5669,1150692,common_voice_en_26286.mp3,"These are the spies, said one of the men.",8,2,female_feminine,6,2712
5670,883922,common_voice_en_35051711.mp3,"The ""Crush"" music video was directed by Chris Applebaum and edited by Nabil Mechi.",6,0,female_feminine,6,6876
5671,178410,common_voice_en_34294891.mp3,"The basis of this mandatory service is to ""increase the cohesion of the nation"".",6,0,female_feminine,6,7200
5672,178895,common_voice_en_108277.mp3,This was the strangest of all things that ever came to earth from outer space.,7,1,female_feminine,6,5760
5673,995240,common_voice_en_48719.mp3,He understands the forces of nature.,6,0,female_feminine,6,4032
5674,178901,common_voice_en_108284.mp3,I thought the unscrewing might be automatic.,6,0,female_feminine,6,4464
5675,883926,common_voice_en_35051717.mp3,A rectangular courtyard with two rows of limestone arcades was added to it later.,6,0,female_feminine,6,7056
5676,883927,common_voice_en_35051718.mp3,Williams never made it to the National Basketball Association.,6,0,female_feminine,6,5328
5677,1663254,common_voice_en_38016215.mp3,He is currently imprisoned.,6,0,female_feminine,6,3456
5678,883928,common_voice_en_35051719.mp3,John Alcott won for Best Cinematography.,6,0,female_feminine,6,4860
5679,1150684,common_voice_en_26278.mp3,"The camel driver, though, seemed not to be very concerned with the threat of war.",6,0,female_feminine,6,4944
5680,711796,common_voice_en_42031.mp3,"He had found where his treasure was, and was frightened at what might happen.",6,0,female_feminine,6,5904
5681,883929,common_voice_en_35051720.mp3,"Although many productions have been staged worldwide, ""Blondel"" has never appeared on Broadway.",6,0,female_feminine,6,6768
5682,883923,common_voice_en_35051712.mp3,"The characters are loosely based on the first American theatrical family, the Barrymores.",6,0,female_feminine,6,6768
5683,883915,common_voice_en_35051700.mp3,Noirmoutier is home to the most expensive potatoes in the world.,6,0,female_feminine,6,5940
5684,995261,common_voice_en_48740.mp3,"I thought that someday I'd be rich, and could go to Mecca.",6,0,female_feminine,6,5448
5685,1657651,common_voice_en_37913081.mp3,Commission rates and fees are negotiable and not regulated.,6,0,female_feminine,6,6120
5686,1658084,common_voice_en_37927549.mp3,On the accession of Elizabeth he returned to England.,6,0,female_feminine,6,7308
5687,883938,common_voice_en_35051777.mp3,The architect was Dmitry Chechulin.,6,0,female_feminine,6,4968
5688,1150610,common_voice_en_26204.mp3,What's the fifth obligation? the boy asked.,6,0,female_feminine,6,2976
5689,883916,common_voice_en_35051701.mp3,"In computing, carrying is an important function of adder circuits.",6,0,female_feminine,6,6300
5690,883917,common_voice_en_35051702.mp3,The two voice actors sometimes rotated the voice of Winnie the Pooh.,6,0,female_feminine,6,7056
5691,1150612,common_voice_en_26206.mp3,"I finally have enough money, and all the time I need.",6,0,female_feminine,6,3360
5692,1150641,common_voice_en_26235.mp3,Just by looking at them.,6,0,female_feminine,6,2160
5693,883936,common_voice_en_35051756.mp3,We hope this campaign will help us achieve that.,6,0,female_feminine,6,4968
5694,883919,common_voice_en_35051704.mp3,"Lyrically, most of Possessed's songs focused on Satanism and death.",6,0,female_feminine,6,7020
5695,883935,common_voice_en_35051755.mp3,I have it still.,6,0,female_feminine,6,4608
5696,1150664,common_voice_en_26258.mp3,"Yes, that's what love is.",6,0,female_feminine,6,2640
5697,1150666,common_voice_en_26260.mp3,Why did you want to see me? the boy asked.,7,1,female_feminine,6,2880
5698,216010,common_voice_en_53437.mp3,The night was warm and I was thirsty.,6,0,female_feminine,6,3504
5699,995201,common_voice_en_48673.mp3,"He was tense and upset, because he knew that the old man was right.",6,0,female_feminine,6,3696
5700,438092,common_voice_en_56983.mp3,It was dropping off in flakes and raining down on the sand.,6,0,female_feminine,6,5784
5701,883934,common_voice_en_35051754.mp3,He dresses hurriedly and sets fire to the area.,6,0,female_feminine,6,5616
5702,202635,common_voice_en_39750682.mp3,The West Branch of the Saint Francis River flows through the community.,6,0,female_feminine,6,5400
5703,883918,common_voice_en_35051703.mp3,There are three ways for the player to find a Medal.,6,0,female_feminine,6,4680
5704,637825,common_voice_en_62487.mp3,"Had our instruments permitted it, we might have been able to see the trouble way back when.",6,0,female_feminine,6,5640
5705,883863,common_voice_en_33342724.mp3,Richards also writes on patriarchy and democracy.,6,0,female_feminine,6,5076
5706,216598,common_voice_en_503627.mp3,Then came the night of the first falling star.,6,0,female_feminine,6,4968
5707,883864,common_voice_en_33342725.mp3,A latchkey represents the logo of the society.,6,0,female_feminine,6,5328
5708,883865,common_voice_en_33342726.mp3,Buyer beware!,6,0,female_feminine,6,3060
5709,883866,common_voice_en_33342727.mp3,The couple had four sons.,6,0,female_feminine,6,3996
5710,883867,common_voice_en_33342748.mp3,Robby is the son of college basketball coach Keith Dambrot.,6,0,female_feminine,6,6120
5711,883957,common_voice_en_36481352.mp3,Many maple species lend themselves to bonsai treatment.,6,0,female_feminine,6,5868
5712,637797,common_voice_en_62459.mp3,"He did find it, soon after dawn, and not far from the sand pits.",6,0,female_feminine,6,5040
5713,1479691,common_voice_en_35002013.mp3,The wing provided aeromedical airlift and flew humanitarian missions as required.,6,0,female_feminine,6,5760
5714,1150545,common_voice_en_26139.mp3,He had been so far away that his face wasn't even visible.,6,0,female_feminine,6,3336
5715,637830,common_voice_en_62492.mp3,"The shop folks were taking down their shutters, and people were opening their bedroom windows.",6,0,female_feminine,6,6768
5716,1150548,common_voice_en_26142.mp3,What is it that I still need to know? the boy asked.,6,0,female_feminine,6,3480
5717,1479409,common_voice_en_34962622.mp3,"Davidson studied classical languages at Queen's College, Oxford.",6,0,female_feminine,6,4860
5718,883956,common_voice_en_36481351.mp3,The mussels are grown and harvested entirely at sea in a mostly natural process.,6,0,female_feminine,6,7416
5719,883870,common_voice_en_33342752.mp3,Nelson produced drawings in crayon.,6,0,female_feminine,6,4248
5720,711815,common_voice_en_42050.mp3,"And to do that, you need money.",6,0,female_feminine,6,4104
5721,883955,common_voice_en_36481350.mp3,No sooner has he defeated Riot then an old enemy returns for a rematch.,6,0,female_feminine,6,6840
5722,883954,common_voice_en_36481349.mp3,Both a market and a fair are still extant.,6,0,female_feminine,6,5076
5723,637799,common_voice_en_62461.mp3,"And at that I told him, and he took my place.",6,0,female_feminine,6,3264
5724,1657803,common_voice_en_37916147.mp3,He called for new scientific research in the field.,6,0,female_feminine,6,6948
5725,883964,common_voice_en_36481379.mp3,"Aside from the borrowed song title, the melodies are completely different.",6,0,female_feminine,6,6696
5726,883857,common_voice_en_33342361.mp3,He currently skips his own team on the World Curling Tour.,6,0,female_feminine,6,5868
5727,883858,common_voice_en_33342362.mp3,It urges all the sides to put their differences aside.,6,0,female_feminine,6,5796
5728,883963,common_voice_en_36481373.mp3,Winnie-the-Pooh Sing a Song volumes are being incorporated into the Sing Along Songs series.,6,0,female_feminine,6,8388
5729,883859,common_voice_en_33342363.mp3,Four Corinthian columns rise from the second story to the third story.,6,0,female_feminine,6,6156
5730,1150514,common_voice_en_26108.mp3,But she said nothing.,6,0,female_feminine,6,1752
5731,883961,common_voice_en_36481371.mp3,"She is a former pupil of the Mountbatten School in Romsey, Hampshire.",6,0,female_feminine,6,6516
5732,957155,common_voice_en_33010343.mp3,His father was an architect and his mother was an artist.,6,0,female_feminine,6,5796
5733,883958,common_voice_en_36481353.mp3,"Klein discovered and signed The Units, Romeo Void, Translator and Wire Train among others.",6,0,female_feminine,6,8856
5734,637817,common_voice_en_62479.mp3,But I found it difficult to get to work because of the investigations.,6,0,female_feminine,6,4392
5735,207057,common_voice_en_128513.mp3,"There were raised voices,and some sort of struggle appeared to be going on. .",6,0,female_feminine,6,7272
5736,442039,common_voice_en_173866.mp3,It was no more exciting than an overturned carriage or a tree blown across the road.,6,0,female_feminine,6,5208
5737,200533,common_voice_en_31281348.mp3,The site is affiliated with the Franciscans.,6,0,female_feminine,6,5688
5738,883860,common_voice_en_33342364.mp3,Robertson led the Irish campaign for the next few years.,6,0,female_feminine,6,5436
5739,883861,common_voice_en_33342365.mp3,Caledonians won the annual championship as the remaining fixtures were not played.,6,0,female_feminine,6,6336
5740,1660769,common_voice_en_37970158.mp3,They also organize local events which are open all members.,6,0,female_feminine,6,5148
5741,706095,common_voice_en_18012930.mp3,To have is better than to wait and hope.,7,1,female_feminine,6,4152
5742,1660714,common_voice_en_37968594.mp3,She currently serves as Chief of Navy.,8,2,female_feminine,6,4428
5743,1656846,common_voice_en_37888724.mp3,They are appointed by the Council of Ministers at the request of the Premier.,6,0,female_feminine,6,7416
5744,1150520,common_voice_en_26114.mp3,"He needs three days, answered the alchemist.",6,0,female_feminine,6,3072
5745,883885,common_voice_en_33342845.mp3,He played college football at Louisiana Tech University.,6,0,female_feminine,6,5040
5746,883886,common_voice_en_33342848.mp3,Besides stage roles he has also acted on films and television series.,6,0,female_feminine,6,5616
5747,883887,common_voice_en_33342850.mp3,That was the best part of this movie.,6,0,female_feminine,6,3636
5748,219018,common_voice_en_10050.mp3,"Finally, after hours of waiting, the guard bade the boy enter.",6,0,female_feminine,6,14616
5749,637839,common_voice_en_62501.mp3,No one seemed to have thought about it that night.,6,0,female_feminine,6,2880
5750,637811,common_voice_en_62473.mp3,Some of the grey ash was falling off the circular edge.,6,0,female_feminine,6,3792
5751,219020,common_voice_en_10052.mp3,That's the way it will be with our love for each other.,6,0,female_feminine,6,5136
5752,1657898,common_voice_en_37919691.mp3,"For this reason, collectors were desperately looking for him.",6,0,female_feminine,6,6336
5753,711803,common_voice_en_42038.mp3,So it's better to listen to what it has to say.,6,0,female_feminine,6,4704
5754,1656759,common_voice_en_37887096.mp3,"Before all these predictions, a battle was to take place.",6,0,female_feminine,6,5580
5755,883925,common_voice_en_35051715.mp3,"In the same year, he became Grand Chancellor of the Legion of Honour.",6,0,female_feminine,6,5580
5756,1658050,common_voice_en_37924098.mp3,It took about four months to complete.,6,0,female_feminine,6,4428
5757,449494,common_voice_en_645241.mp3,"Sadly, my dream of becoming a squirrel whisperer may never happen.",6,0,female_feminine,6,8496
5758,647208,common_voice_en_33135507.mp3,Most of them are now in private collections.,6,0,female_feminine,6,4176
5759,1479531,common_voice_en_34963718.mp3,Other manufacturers provided refits for adapting the Speed Wagon for specialized purposes.,6,0,female_feminine,6,6696
5760,711800,common_voice_en_42035.mp3,"I'm an adventurer, looking for treasure, he said to himself.",6,0,female_feminine,6,5208
5761,883890,common_voice_en_33342884.mp3,These have included many one person exhibitions as well as group exhibitions.,6,0,female_feminine,6,6336
5762,883891,common_voice_en_33342885.mp3,She was trained by Wiebe Kort.,6,0,female_feminine,6,3996
5763,883893,common_voice_en_33342887.mp3,She also stated that she had not been paid for the month of March.,6,0,female_feminine,6,5220
5764,1663310,common_voice_en_38017892.mp3,Jacksonville Beach has a humid subtropical climate.,6,0,female_feminine,6,6228
5765,1150585,common_voice_en_26179.mp3,So how will we name all these hurricanes?,7,1,female_feminine,6,2712
5766,883909,common_voice_en_34983081.mp3,He was elected to the World Figure Skating Hall of Fame.,6,0,female_feminine,6,4716
5767,440457,common_voice_en_36957788.mp3,Rodney was officially stated to be his middle name in the letters column.,6,0,female_feminine,6,5688
5768,883873,common_voice_en_33342765.mp3,The specific epithet refers to Arctic explorer and naturalist John Richardson.,6,0,female_feminine,6,7380
5769,711814,common_voice_en_42049.mp3,That it was unable to deal with this boy who spoke the Language of the World.,6,0,female_feminine,6,6600
5770,454599,common_voice_en_60076.mp3,"I'm going with you, the boy said.",6,0,female_feminine,6,3168
5771,883949,common_voice_en_35051822.mp3,"Norm Everage, an ""average Australian housewife"" from Moonee Ponds, a suburb in Melbourne, Victoria.",6,0,female_feminine,6,8460
5772,883875,common_voice_en_33342767.mp3,Current efforts are aimed at gathering data.,6,0,female_feminine,6,4356
5773,883948,common_voice_en_35051821.mp3,"The firm was based in San Francisco, California.",6,0,female_feminine,6,5076
5774,637836,common_voice_en_62498.mp3,The loafers and golf caddies were used to hanging out near the railway station.,6,0,female_feminine,6,4704
5775,1150572,common_voice_en_26166.mp3,The shepherd swore that he would.,6,0,female_feminine,6,2352
5776,990381,common_voice_en_90508.mp3,Did you say a king? he asked.,6,0,female_feminine,6,2520
5777,883877,common_voice_en_33342795.mp3,She even manages to get her friend Custard to come over for Christmas.,6,0,female_feminine,6,5580
5778,883946,common_voice_en_35051819.mp3,This task is also performed by other miniature horse breeds.,6,0,female_feminine,6,5328
5779,883880,common_voice_en_33342821.mp3,The Komets and Walleye were then approved to postpone their start to February.,6,0,female_feminine,6,5940
5780,711811,common_voice_en_42046.mp3,"Now, I can see that it hasn't been too bad.",6,0,female_feminine,6,4632
5781,711809,common_voice_en_42044.mp3,"I'm surprised, the boy said.",6,0,female_feminine,6,4008
5782,883881,common_voice_en_33342822.mp3,He was considered to be one of the best kicks in his draft class.,6,0,female_feminine,6,4500
5783,883882,common_voice_en_33342823.mp3,She was persuaded to renovate the home instead.,6,0,female_feminine,6,4356
5784,883883,common_voice_en_33342824.mp3,She acted as secretary for District One of the Massachusetts State Nurses Association.,6,0,female_feminine,6,6516
5785,883884,common_voice_en_33342825.mp3,He played college basketball for the Cincinnati Bearcats.,6,0,female_feminine,6,4716
5786,883876,common_voice_en_33342794.mp3,The scene also goes into the dark and violent side of sex.,6,0,female_feminine,6,5796
5787,308892,common_voice_en_31266649.mp3,Final command post at Montbard northwest of Dijon.,6,0,female_feminine,6,4716
5788,308722,common_voice_en_31743175.mp3,Yabe contributed to the development of geology in Japan.,6,0,female_feminine,6,5976
5789,308720,common_voice_en_31743173.mp3,He made his debut for them against Sony Sugar.,6,0,female_feminine,6,5616
5790,308890,common_voice_en_31266632.mp3,This station falls under Alipurduar railway division.,6,0,female_feminine,6,5148
5791,308889,common_voice_en_31266631.mp3,It feeds on polychaetes and benthic crustaceans.,6,0,female_feminine,6,4968
5792,308888,common_voice_en_31266630.mp3,The boar in European cultures is often associated with fire and the sun.,6,0,female_feminine,6,6300
5793,308887,common_voice_en_31266629.mp3,They appear to have been lost.,6,0,female_feminine,6,3636
5794,1109967,common_voice_en_31961702.mp3,The details of her early life are unknown.,6,0,female_feminine,6,4068
5795,308728,common_voice_en_31743192.mp3,The Governor and Legislature of Guam have been engaged with the Guam Military Buildup.,6,0,female_feminine,6,6444
5796,308727,common_voice_en_31743191.mp3,Sarah occasionally purchased drugs from the brothers.,6,0,female_feminine,6,4176
5797,999553,common_voice_en_32877020.mp3,Records exist from the archives of the Agios Charalambos church in Zakynthos.,6,0,female_feminine,6,7884
5798,308725,common_voice_en_31743189.mp3,Scheer was born in Berlin.,6,0,female_feminine,6,3276
5799,308724,common_voice_en_31743177.mp3,No secrecy will be broken.,6,0,female_feminine,6,3672
5800,308723,common_voice_en_31743176.mp3,Teva and Wolf catch up to the Mandalorian where they slew some ice spiders.,6,0,female_feminine,6,6444
5801,1109981,common_voice_en_31961738.mp3,He explained that they had failed to keep the records up to date.,6,0,female_feminine,6,4356
5802,308648,common_voice_en_36069018.mp3,"They are elongated fish, although not as much so as the true eels.",6,0,female_feminine,6,5580
5803,375887,common_voice_en_37635.mp3,"Of course, the two were unable to do anything.",6,0,female_feminine,6,4704
5804,375891,common_voice_en_37639.mp3,We lit the lantern and walked over to his house.,6,0,female_feminine,6,4824
5805,375892,common_voice_en_37640.mp3,It brought his heart into his mouth.,7,1,female_feminine,6,4320
5806,375895,common_voice_en_37643.mp3,And the sand and gravel had been flung violently in every direction.,6,0,female_feminine,6,7080
5807,375900,common_voice_en_37648.mp3,Everyone seemed very excited.,6,0,female_feminine,6,4488
5808,375902,common_voice_en_37650.mp3,Most of them were staring quietly at the big table.,6,0,female_feminine,6,4416
5809,308726,common_voice_en_31743190.mp3,The following results can be proven using the ultrafilter lemma.,6,0,female_feminine,6,4932
5810,798245,common_voice_en_38560014.mp3,Hollis won the election.,6,0,female_feminine,6,4284
5811,373132,common_voice_en_30785745.mp3,Toye.,6,0,female_feminine,6,3636
5812,1376287,common_voice_en_38377224.mp3,Verona Beach State Park is located north of the mouth.,6,0,female_feminine,6,5076
5813,1109856,common_voice_en_31961344.mp3,Implemented by the Republican controlled New York Legislature under Governor Charles Evans Hughes.,6,0,female_feminine,6,8568
5814,1109861,common_voice_en_31961367.mp3,All the matches are composed of four clubs.,6,0,female_feminine,6,5076
5815,798266,common_voice_en_38560072.mp3,The slender cast iron span of Cleveland Bridge required reinforcement.,6,0,female_feminine,6,5292
5816,1529910,common_voice_en_32115400.mp3,The tax was amount depended on their breast size.,6,0,female_feminine,6,4680
5817,798265,common_voice_en_38560068.mp3,"How does it, for example, apply to the complex issue of fan fiction?",6,0,female_feminine,6,5256
5818,797938,common_voice_en_607148.mp3,The burning fire had been extinguished.,6,0,female_feminine,6,4008
5819,1109872,common_voice_en_31961393.mp3,Ordinary stars are composed mainly of the light elements hydrogen and helium.,6,0,female_feminine,6,7416
5820,798250,common_voice_en_38560027.mp3,Her loan to Brazil was extended beyond its original five-year term at regular intervals.,6,0,female_feminine,6,6264
5821,308893,common_voice_en_31266650.mp3,The work was recorded several times.,6,0,female_feminine,6,3600
5822,1529885,common_voice_en_32115359.mp3,It is approved for emergency use in India.,6,0,female_feminine,6,3600
5823,1522021,common_voice_en_36842388.mp3,There are no mountain ranges in the municipality.,6,0,female_feminine,6,3168
5824,1522018,common_voice_en_36842385.mp3,"Additionally, one fatality was reported.",6,0,female_feminine,6,3240
5825,1109893,common_voice_en_31961439.mp3,Everest and reaching New Heights.,6,0,female_feminine,6,3348
5826,1529899,common_voice_en_32115389.mp3,She never remarried and spent the rest of her life in Norway.,6,0,female_feminine,6,4716
5827,797902,common_voice_en_607112.mp3,"Down below in the darkness were hundreds of people, sleeping in peace.",6,0,female_feminine,6,10080
5828,1109926,common_voice_en_31961555.mp3,Colors were Sapphire Blue and Gold.,6,0,female_feminine,6,3060
5829,1109963,common_voice_en_31961687.mp3,Russia’s economy is reeling and Putin alone is to blame.,6,0,female_feminine,6,5616
5830,1529972,common_voice_en_32115556.mp3,The initial concept phase of the programme was scheduled to last for three years.,6,0,female_feminine,6,5580
5831,308896,common_voice_en_31266653.mp3,Celebrities have visited the restaurant which has also seen several longtime employees.,6,0,female_feminine,6,5940
5832,308894,common_voice_en_31266651.mp3,The moor is now mainly afforested with pine trees.,6,0,female_feminine,6,4536
5833,798249,common_voice_en_38560024.mp3,Browning spent much of his work exploring and questioning religion through his dramatic monologues.,6,0,female_feminine,6,7488
5834,797227,common_voice_en_30453345.mp3,"Three singles were released from ""Vicarious"".",6,0,female_feminine,6,4932
5835,797258,common_voice_en_30453379.mp3,She was awarded the Hans Christian Andersen Prize.,6,0,female_feminine,6,5544
5836,908678,common_voice_en_31990311.mp3,The couple sustained no physical injuries from the explosion.,6,0,female_feminine,6,4788
5837,797257,common_voice_en_30453378.mp3,The entire route is within the city of Kempton Park.,6,0,female_feminine,6,5004
5838,797256,common_voice_en_30453377.mp3,One the houses of New Hall School is called Dennett House.,6,0,female_feminine,6,5940
5839,797255,common_voice_en_30453376.mp3,The flagship radio stations for both teams also produced local broadcasts of each game.,6,0,female_feminine,6,8460
5840,797254,common_voice_en_30453375.mp3,It is in northeast Minnesota.,6,0,female_feminine,6,4572
5841,797253,common_voice_en_30453374.mp3,Actress and musical theatre graduate Chloe Bremner sang the national anthem.,6,0,female_feminine,6,6372
5842,908639,common_voice_en_31959950.mp3,Christoph Schweizer was born in Germany.,6,0,female_feminine,6,3276
5843,797252,common_voice_en_30453373.mp3,Valdez grew up in Ripon California.,6,0,female_feminine,6,4752
5844,797251,common_voice_en_30453372.mp3,She also established caring maternity crib institutions for the children of working mothers.,6,0,female_feminine,6,7452
5845,908742,common_voice_en_32043335.mp3,Teams qualified for the finals,6,0,female_feminine,6,3672
5846,797249,common_voice_en_30453370.mp3,He learned the Japanese language in Japan.,6,0,female_feminine,6,4824
5847,797248,common_voice_en_30453368.mp3,Both are measured from the point in the sky where Aries begins.,6,0,female_feminine,6,5508
5848,797247,common_voice_en_30453367.mp3,His next challenge was to win delegates at the Democratic National Convention.,6,0,female_feminine,6,6480
5849,797246,common_voice_en_30453366.mp3,A deserved hit.,6,0,female_feminine,6,3996
5850,797245,common_voice_en_30453365.mp3,She is known for her research on the genetics of common human diseases.,6,0,female_feminine,6,5724
5851,797244,common_voice_en_30453364.mp3,He is known for his research and editing works on medieval Gujarati literature.,6,0,female_feminine,6,9144
5852,797242,common_voice_en_30453362.mp3,Watson grew up in Chicago.,6,0,female_feminine,6,3672
5853,797241,common_voice_en_30453361.mp3,Three from the Poole People Party.,6,0,female_feminine,6,4212
5854,797240,common_voice_en_30453360.mp3,The area of North Street lay within the civilian settlement of Roman Eboracum.,6,0,female_feminine,6,6984
5855,797239,common_voice_en_30453358.mp3,The poetry of Mgr.,6,0,female_feminine,6,5580
5856,908650,common_voice_en_31985369.mp3,Former team captain Harvey Tafe was brought in to keep the team afloat.,6,0,female_feminine,6,5580
5857,797250,common_voice_en_30453371.mp3,Aarav confronts Reema and she blames Simar responsible for her stare.,6,0,female_feminine,6,7668
5858,1530019,common_voice_en_32120237.mp3,Two of the games were eventually canceled outright.,6,0,female_feminine,6,3708
5859,1529995,common_voice_en_32120182.mp3,He served as butler.,6,0,female_feminine,6,3528
5860,908721,common_voice_en_31990568.mp3,He served numerous leadership positions in the East Sea Fleet and South Sea Fleet.,6,0,female_feminine,6,6624
5861,1530013,common_voice_en_32120218.mp3,He represented his country at one outdoor and one indoor European Championships.,6,0,female_feminine,6,6516
5862,1521951,common_voice_en_36842283.mp3,"Will Smith is a street smart teenager, born and raised in West Philadelphia.",6,0,female_feminine,6,5760
5863,797282,common_voice_en_30453404.mp3,This championship marks the end of the protective mask for the face.,6,0,female_feminine,6,6768
5864,797281,common_voice_en_30453403.mp3,It is categorized as Critically Endangered.,6,0,female_feminine,6,4572
5865,797280,common_voice_en_30453402.mp3,The complex is inscribed on the list of Immovable Cultural Monuments of National Significance.,6,0,female_feminine,6,7308
5866,797279,common_voice_en_30453401.mp3,Site official,6,0,female_feminine,6,2880
5867,797277,common_voice_en_30453399.mp3,The league currently features twelve teams.,6,0,female_feminine,6,4320
5868,797276,common_voice_en_30453398.mp3,He was educated at Fettes College and Oxford University.,6,0,female_feminine,6,6336
5869,797260,common_voice_en_30453381.mp3,I just couldn’t overpower people.,6,0,female_feminine,6,4068
5870,797274,common_voice_en_30453396.mp3,His Bengali name could not be discovered.,6,0,female_feminine,6,3780
5871,797273,common_voice_en_30453395.mp3,"It is the second Jordanian Netflix original series after ""Jinn"".",6,0,female_feminine,6,6984
5872,797271,common_voice_en_30453393.mp3,Previous writings gave no precise location for the sermon.,6,0,female_feminine,6,4608
5873,797269,common_voice_en_30453391.mp3,The National League campaign saw the team come close to relegation.,6,0,female_feminine,6,6264
5874,797268,common_voice_en_30453390.mp3,No money was earned for the pot.,6,0,female_feminine,6,3888
5875,797266,common_voice_en_30453388.mp3,I will now teach you martial arts.,6,0,female_feminine,6,5796
5876,797265,common_voice_en_30453386.mp3,She also attended the opera class.,6,0,female_feminine,6,4428
5877,797264,common_voice_en_30453385.mp3,"Streams are ""weighted"" through paid subscriptions holding more weight than streams from free subscriptions.",6,0,female_feminine,6,8532
5878,797263,common_voice_en_30453384.mp3,The tiled stoves have been preserved.,6,0,female_feminine,6,4248
5879,797262,common_voice_en_30453383.mp3,The voice was bass.,6,0,female_feminine,6,4032
5880,797261,common_voice_en_30453382.mp3,Arab tribes in Mesopotamia were initially enthusiastic about the Jihad.,6,0,female_feminine,6,6480
5881,797243,common_voice_en_30453363.mp3,Mike Pender has stated that he wrote the music and Chris Curtis the lyrics.,6,0,female_feminine,6,5724
5882,1376204,common_voice_en_38376792.mp3,The eggs and larvae of the red hogfish are pelagic.,6,0,female_feminine,6,5940
5883,371377,common_voice_en_31303683.mp3,She attended Fairmont Senior High School and Fairmont State College.,6,0,female_feminine,6,6228
5884,371379,common_voice_en_31303735.mp3,He eventually attended Cahokia High School.,6,0,female_feminine,6,4392
5885,1376209,common_voice_en_38376819.mp3,Rolfe and his Lucky Strike Orchestra.,6,0,female_feminine,6,4680
5886,1663675,common_voice_en_38022708.mp3,The bride was sixteen years old and the groom seventeen.,6,0,female_feminine,6,5256
5887,1376212,common_voice_en_38376830.mp3,The monastery enjoyed the patronage of the ruling Princes of Uglich.,6,0,female_feminine,6,6156
5888,1376213,common_voice_en_38376836.mp3,The acrimony over the Dred Scott decision had blossomed into mutual distrust.,6,0,female_feminine,6,6408
5889,1376247,common_voice_en_38377031.mp3,The Sydney Gazette and New South Wales Advertiser.,6,0,female_feminine,6,6300
5890,371364,common_voice_en_31303612.mp3,Bembridge finished joint second with Alan Murray and Frank Phillips.,6,0,female_feminine,6,6552
5891,1376218,common_voice_en_38376849.mp3,"The third single was ""Prodigal Blues"".",6,0,female_feminine,6,4176
5892,371365,common_voice_en_31303613.mp3,Powell is fluent in Spanish,6,0,female_feminine,6,4716
5893,1529902,common_voice_en_32115392.mp3,She is an associate professor of computer science at the University of Washington.,6,0,female_feminine,6,5328
5894,1376222,common_voice_en_38376866.mp3,A small pictorial display and a cast iron fountain is located outside the hall.,6,0,female_feminine,6,8280
5895,371380,common_voice_en_31303736.mp3,He has taken lessons in classical music from Suresh Wadkar.,6,0,female_feminine,6,5688
5896,371381,common_voice_en_31303737.mp3,Other prisoners came from countries like the Soviet Union and Germany.,6,0,female_feminine,6,6264
5897,1522062,common_voice_en_36842505.mp3,Edmund went to London.,6,0,female_feminine,6,2340
5898,1663499,common_voice_en_38021193.mp3,What shall we talk about?,6,0,female_feminine,6,3060
5899,1376264,common_voice_en_38377158.mp3,The autonomy of the Indians was eroded by the dismantling of their lands.,6,0,female_feminine,6,7200
5900,314149,common_voice_en_620388.mp3,"There were really, I think, two or three hundred people elbowing one another.",6,0,female_feminine,6,5016
5901,1529775,common_voice_en_32115170.mp3,It will be televised nationally by Fox.,6,0,female_feminine,6,4068
5902,1376242,common_voice_en_38376995.mp3,Jurgens assumed writing duties following four issues by guests Chuck Dixon and Rick Remender.,6,0,female_feminine,6,7740
5903,1376246,common_voice_en_38377025.mp3,"Subsequently, the characters started to age in real time and undergo significant life changes.",6,0,female_feminine,6,8208
5904,1376280,common_voice_en_38377210.mp3,Bollea occasionally attended amateur drifting competitions.,9,3,female_feminine,6,6516
5905,371531,common_voice_en_40328769.mp3,The collection has been referred to as the Blumberg Collection.,6,0,female_feminine,6,4824
5906,1522178,common_voice_en_36842974.mp3,The entire routing is in San Bernardino County.,6,0,female_feminine,6,3240
5907,370584,common_voice_en_577109.mp3,"Sadly, my dream of becoming a squirrel whisperer may never happen.",6,0,female_feminine,6,5424
5908,371075,common_voice_en_30674080.mp3,A rooftop restaurant was also planned.,6,0,female_feminine,6,4536
5909,1660385,common_voice_en_37962805.mp3,This is mainly the reason why this area was declared a National park.,6,0,female_feminine,6,6696
5910,722285,common_voice_en_125746.mp3,"When you play cards the first time, you are almost sure to win.",6,0,female_feminine,6,5688
5911,1522140,common_voice_en_36842852.mp3,This layout makes use of the Spanish solution.,8,2,female_feminine,6,4284
5912,1376177,common_voice_en_38369396.mp3,Loop diuretics cause a decrease in the renal blood flow by this mechanism.,6,0,female_feminine,6,7956
5913,371059,common_voice_en_30674063.mp3,Artwork by Stewart was displayed for the first time.,6,0,female_feminine,6,5616
5914,1376181,common_voice_en_38376569.mp3,Others were created because of segregation imposed by the colonialists.,6,0,female_feminine,6,7056
5915,1376215,common_voice_en_38376842.mp3,The bone was sticking up straight through my shoulder where I cut three ligaments.,6,0,female_feminine,6,7236
5916,1376185,common_voice_en_38376627.mp3,Recent conductors have included David Russell Hulme and Martin Handley.,6,0,female_feminine,6,7308
5917,371374,common_voice_en_31303680.mp3,Bogue was the first woman elected to the city council.,6,0,female_feminine,6,5292
5918,371070,common_voice_en_30674075.mp3,"A negative review comes from Aaron Timms in ""The Outline"".",6,0,female_feminine,6,6228
5919,371074,common_voice_en_30674079.mp3,New models have been proposed to explain the discrepancy.,6,0,female_feminine,6,6048
5920,1376193,common_voice_en_38376755.mp3,Newell benefited from the presence of independent and anti-nuclear activist Helen Caldicott.,6,0,female_feminine,6,8748
5921,1376194,common_voice_en_38376756.mp3,"In older systems, mycobacteria are grouped based upon their appearance and rate of growth.",6,0,female_feminine,6,8676
5922,1376195,common_voice_en_38376760.mp3,"He moved to Indonesia, where he was supposed to spend his sentence imprisoned.",6,0,female_feminine,6,8136
5923,371363,common_voice_en_31303611.mp3,The creek was formerly called Squaw Creek.,6,0,female_feminine,6,4968
5924,1376201,common_voice_en_38376776.mp3,There are smaller structures as well: spots of different sizes and colors.,6,0,female_feminine,6,6120
5925,1376202,common_voice_en_38376777.mp3,"There are many claims of Norse colonization in New England, none well-founded.",6,0,female_feminine,6,7920
5926,371369,common_voice_en_31303650.mp3,Tournament winners are no longer given automatic entry into the championship.,6,0,female_feminine,6,6552
5927,371370,common_voice_en_31303651.mp3,The thiolate is then hydrolyzed,6,0,female_feminine,6,4428
5928,371372,common_voice_en_31303653.mp3,Jesus appears enthroned between Mary and John the Baptist.,6,0,female_feminine,6,5904
5929,371069,common_voice_en_30674074.mp3,He signed with the team the next day.,6,0,female_feminine,6,5040
5930,372615,common_voice_en_32650167.mp3,She dabbled in fashion and eventually began making commentaries on cultural and social issues.,6,0,female_feminine,6,9900
5931,1109786,common_voice_en_31939656.mp3,His research centered on plasma and the technology of high voltage electricity.,6,0,female_feminine,6,7668
5932,1109787,common_voice_en_31939659.mp3,It is located in the British Museum.,6,0,female_feminine,6,5796
5933,1529874,common_voice_en_32115347.mp3,All species are found in the Southern Hemisphere.,6,0,female_feminine,6,3960
5934,798290,common_voice_en_38565375.mp3,"When she declines, they say she has no choice.",6,0,female_feminine,6,3924
5935,798287,common_voice_en_38565362.mp3,"Other attractions are Geser, a monument, and the King's Gate arch.",6,0,female_feminine,6,4968
5936,1376275,common_voice_en_38377189.mp3,"She studied visual art, film and video at Bennington College.",6,0,female_feminine,6,6480
5937,798284,common_voice_en_38565342.mp3,Bunches of white feathers nod and flutter in the wind.,6,0,female_feminine,6,4320
5938,798283,common_voice_en_38565341.mp3,"That same year, Lavin married William Walsh, a Dublin lawyer.",6,0,female_feminine,6,5544
5939,1376276,common_voice_en_38377190.mp3,"In many states, statutory rape is considered a strict liability offense.",6,0,female_feminine,6,7308
5940,798313,common_voice_en_38568251.mp3,"A cubit arm in heraldry may be ""dexter"" or ""sinister"".",6,0,female_feminine,6,5580
5941,1529754,common_voice_en_32114950.mp3,It is native to Kenya and Tanzania.,6,0,female_feminine,6,3996
5942,1376278,common_voice_en_38377208.mp3,"Bebek accepted, recorded as a studio musician, and then left to serve in Pirot.",6,0,female_feminine,6,7848
5943,798274,common_voice_en_38560097.mp3,Growth hormone treatment has been attempted.,6,0,female_feminine,6,3636
5944,798272,common_voice_en_38560089.mp3,"He was attracted by the west coast, which he had visited as a student.",6,0,female_feminine,6,5436
5945,798268,common_voice_en_38560078.mp3,Afterwards experts noticed that they were modern forgeries.,6,0,female_feminine,6,4716
5946,798267,common_voice_en_38560077.mp3,Not using an international standard pallet can increase transport costs of international trade.,6,0,female_feminine,6,7632
5947,798298,common_voice_en_38565393.mp3,All of these are usually less than deep.,6,0,female_feminine,6,3492
5948,798262,common_voice_en_38560060.mp3,The festival originally celebrated the beginning of the year.,6,0,female_feminine,6,4572
5949,798260,common_voice_en_38560047.mp3,The city was named for railroad employee Robert William Pooler.,6,0,female_feminine,6,4788
5950,798258,common_voice_en_38560042.mp3,The Town is surrounded by swampland.,6,0,female_feminine,6,3096
5951,798257,common_voice_en_38560040.mp3,"He lost when Coe Crawford and Peter Norbeck both supported the incumbent, Thomas Sterling.",6,0,female_feminine,6,6516
5952,798280,common_voice_en_38560848.mp3,Tissue macrophages play an important role in chronic inflammation and wound repair.,6,0,female_feminine,6,7488
5953,798278,common_voice_en_38560829.mp3,"The ""Bub Motorcycle Speed Trials"" are for motorcycles only.",6,0,female_feminine,6,5220
5954,1529792,common_voice_en_32115218.mp3,The film consists of two series.,6,0,female_feminine,6,3600
5955,798337,common_voice_en_38577175.mp3,The actual decision of the court was in fact based on other findings.,6,0,female_feminine,6,4320
5956,1376254,common_voice_en_38377058.mp3,Perles' most important essays were on folklore and custom.,6,0,female_feminine,6,6156
5957,1376256,common_voice_en_38377060.mp3,Campbell was serving as a scout for Major General Middleton.,6,0,female_feminine,6,5220
5958,1376260,common_voice_en_38377148.mp3,"The following year, Emma-Jayne Wilson became the first female jockey to win the race.",6,0,female_feminine,6,7056
5959,1376261,common_voice_en_38377150.mp3,This was followed by the command of the military administration to do forced labor.,6,0,female_feminine,6,7920
5960,1376262,common_voice_en_38377152.mp3,Government policy has since focussed on rewarding personal merit through royal decorations.,6,0,female_feminine,6,7236
5961,798332,common_voice_en_38577104.mp3,The technical details of the adjustment are described in Tabular Islamic calendar.,6,0,female_feminine,6,5400
5962,1376266,common_voice_en_38377167.mp3,The party was always illegal and persecuted by the regime.,6,0,female_feminine,6,5328
5963,1660272,common_voice_en_37961104.mp3,Students also learned dance and music at the school.,6,0,female_feminine,6,5148
5964,798322,common_voice_en_38568318.mp3,Hispanic or Latin.,6,0,female_feminine,6,2700
5965,372614,common_voice_en_32650165.mp3,William Aiken House.,6,0,female_feminine,6,4428
5966,1376270,common_voice_en_38377182.mp3,The station is located on the Croy Line between Glasgow Queen Street and Dunblane.,6,0,female_feminine,6,9180
5967,908751,common_voice_en_32071348.mp3,"It also allowed local authorities to ""provide and maintain museums and art galleries"".",6,0,female_feminine,6,6732
5968,372616,common_voice_en_32650168.mp3,The man chooses the latter and Limehouse allows him to go.,6,0,female_feminine,6,6696
5969,312011,common_voice_en_88177.mp3,"So, he asked if the old man's blessing was still with him.",6,0,female_feminine,6,3984
5970,312004,common_voice_en_88170.mp3,But the king of Salem hoped desperately that the boy would be successful.,6,0,female_feminine,6,6984
5971,798299,common_voice_en_38565394.mp3,"Also on disc one are bonus tracks, alternate vocals, and alternate mixes.",6,0,female_feminine,6,5796
5972,311997,common_voice_en_88163.mp3,Several figures approached him.,6,0,female_feminine,6,3024
5973,798329,common_voice_en_38577083.mp3,The square also contains a large lawn and a public fountain.,6,0,female_feminine,6,4572
5974,311963,common_voice_en_32960759.mp3,He is currently the president of the foundation.,6,0,female_feminine,6,4680
5975,372612,common_voice_en_32650162.mp3,It is within the Ohio River National Freedom Corridor.,6,0,female_feminine,6,7668
5976,372613,common_voice_en_32650164.mp3,In the Hanseatic town of Visby the situation differed from that in the countryside.,6,0,female_feminine,6,8388
5977,798320,common_voice_en_38568302.mp3,Lager Helgoland was filled with Russian Organisation Todt volunteer workers.,6,0,female_feminine,6,6372
5978,793945,common_voice_en_37126392.mp3,He then became a regular adapter for the New York City Center Encores!,6,0,female_feminine,6,7992
5979,793942,common_voice_en_37126370.mp3,French transferred to Springfield Commonwealth Academy following his freshman year.,6,0,female_feminine,6,8748
5980,1530488,common_voice_en_32259294.mp3,The leaves are hairy and have toothed or wavy edges.,6,0,female_feminine,6,4320
5981,793940,common_voice_en_37126367.mp3,Tents and bonfires are allowed only in designated areas.,6,0,female_feminine,6,6984
5982,793939,common_voice_en_37126366.mp3,The event was run in two rounds.,6,0,female_feminine,6,4608
5983,793937,common_voice_en_37126354.mp3,All candidates must also obtain a security clearance.,6,0,female_feminine,6,6120
5984,567306,common_voice_en_83166.mp3,"Besides that, there was a heap of bicycles.",6,0,female_feminine,6,3024
5985,793932,common_voice_en_37126341.mp3,It was built by contractors Alexander Mathers and Cecil Walker.,6,0,female_feminine,6,8388
5986,793929,common_voice_en_37126173.mp3,This reconstruction was incorporated into the permanent exhibition of the museum.,6,0,female_feminine,6,8568
5987,819149,common_voice_en_680130.mp3,"It was, however, still so hot from its flight through the air.",6,0,female_feminine,6,5064
5988,793928,common_voice_en_37126172.mp3,United Steel Products also has a large facility in town.,6,0,female_feminine,6,6588
5989,797236,common_voice_en_30453354.mp3,The building where the mosque stands today used to be an antique automobile museum.,6,0,female_feminine,6,7020
5990,793926,common_voice_en_37126165.mp3,They were arranged in two groups.,6,0,female_feminine,6,3528
5991,793923,common_voice_en_37126146.mp3,It is not known how effectively this protocol was applied.,6,0,female_feminine,6,6264
5992,793922,common_voice_en_37126145.mp3,"Originally, it was somewhat babyish, with a pronounced Minnesota accent.",6,0,female_feminine,6,8784
5993,793919,common_voice_en_37126093.mp3,He also established the Andhra Scientific Company.,6,0,female_feminine,6,6084
5994,567504,common_voice_en_33194768.mp3,Farhat is Catholic.,6,0,female_feminine,6,3924
5995,793918,common_voice_en_37126092.mp3,"When Nomi lashes out in action or outrage, she is ignored or negated.",6,0,female_feminine,6,8172
5996,1659141,common_voice_en_37942457.mp3,None of his compositions was printed.,6,0,female_feminine,6,4608
5997,793916,common_voice_en_37126063.mp3,The nature of the limbs and vertebrae clearly indicate a terrestrial animal.,6,0,female_feminine,6,7200
5998,793883,common_voice_en_37038181.mp3,"North of Pleasant Mills, the road crosses over the Saint Marys River.",6,0,female_feminine,6,7164
5999,793912,common_voice_en_37125999.mp3,It quickly became known as the Truman Committee.,6,0,female_feminine,6,5076
6000,793911,common_voice_en_37125998.mp3,A few tap the signal after the fader and before the mix buses.,6,0,female_feminine,6,7164
6001,793927,common_voice_en_37126169.mp3,"He can push, pull, and throw the black ball.",6,0,female_feminine,6,4896
6002,1521297,common_voice_en_36612957.mp3,"Meanwhile, Cordelia convinces Connor to keep her sudden pregnancy a secret from everyone else.",6,0,female_feminine,6,5652
6003,611159,common_voice_en_31374379.mp3,The journal changed its title several times.,6,0,female_feminine,6,4068
6004,611166,common_voice_en_31391724.mp3,His sons Berkeley and Robert also sat for the borough.,6,0,female_feminine,6,4716
6005,611316,common_voice_en_186337.mp3,They formed heaps that are visible a mile and a half away.,6,0,female_feminine,6,5160
6006,1530346,common_voice_en_32255876.mp3,Wales.,6,0,female_feminine,6,1800
6007,611326,common_voice_en_186347.mp3,"Yet, it was a little too large for assurance.",6,0,female_feminine,6,4536
6008,1223777,common_voice_en_37963811.mp3,The tower is one of the members of the World Federation of Great Towers.,6,0,female_feminine,6,6552
6009,1530362,common_voice_en_32255980.mp3,Instead Parkes created the new ministry of justice and public instruction.,6,0,female_feminine,6,5076
6010,1223815,common_voice_en_37964012.mp3,Bach; in addition he was formative in the development of the chorale cantata.,6,0,female_feminine,6,7344
6011,1521231,common_voice_en_36612876.mp3,"It occurs in tabular, acicular, or fibrous crystals with a vitreous luster.",6,0,female_feminine,6,6408
6012,1223831,common_voice_en_37964100.mp3,Epiphytes including orchids are common.,6,0,female_feminine,6,4212
6013,793946,common_voice_en_37126393.mp3,The band is gold with black border.,6,0,female_feminine,6,4716
6014,1521239,common_voice_en_36612886.mp3,During World War One the company also produced aero engines.,6,0,female_feminine,6,5256
6015,1530431,common_voice_en_32259182.mp3,The club will join the tournament in the quarterfinals.,6,0,female_feminine,6,3600
6016,1530412,common_voice_en_32259144.mp3,It was built from seamless tubular steel.,6,0,female_feminine,6,3708
6017,1530447,common_voice_en_32259213.mp3,She then lectured at the Department of Radiocommunication.,8,2,female_feminine,6,4716
6018,1530426,common_voice_en_32259171.mp3,The department is managed by the State Service for National Cultural Heritage.,6,0,female_feminine,6,5400
6019,384596,common_voice_en_491410.mp3,"After all, he had all his money.",6,0,female_feminine,6,3504
6020,1521143,common_voice_en_36512018.mp3,"When Ripley defeats the Queen by opening the airlock, Bishop saves Newt.",6,0,female_feminine,6,5652
6021,1530480,common_voice_en_32259275.mp3,The southern part of the creek used to be home to many wood plantations.,6,0,female_feminine,6,4716
6022,1661781,common_voice_en_37989455.mp3,Three of their six children began the family's three major branches.,6,0,female_feminine,6,6696
6023,793947,common_voice_en_37126395.mp3,During the Protestant Reformation the residents left the monastery.,6,0,female_feminine,6,7668
6024,793915,common_voice_en_37126061.mp3,The mansion was surrounded by the residences of senior vassals and clan officials.,6,0,female_feminine,6,7704
6025,1223839,common_voice_en_37964116.mp3,"Protestants, in general, do not see this passage as a justification for Lent.",6,0,female_feminine,6,6768
6026,793859,common_voice_en_37038146.mp3,These centers are open to the community.,6,0,female_feminine,6,5220
6027,793857,common_voice_en_37038144.mp3,What will protect him?,6,0,female_feminine,6,3816
6028,566832,common_voice_en_53500.mp3,"Much better, said the old man.",6,0,female_feminine,6,3912
6029,1520972,common_voice_en_36410479.mp3,This included rebuilding the top five metres of the spire and rebuilding the tracery.,8,2,female_feminine,6,5508
6030,1520918,common_voice_en_36410417.mp3,Her next major work was her largest success though.,6,0,female_feminine,6,3888
6031,819198,common_voice_en_680181.mp3,The thing itself was almost entirely buried in sand.,6,0,female_feminine,6,4272
6032,1530555,common_voice_en_32259491.mp3,The club possesses an acrobatics section.,6,0,female_feminine,6,4896
6033,1520913,common_voice_en_36410411.mp3,"Unlike the full version of Konqueror, Embedded Konqueror is only a web browser.",6,0,female_feminine,6,5508
6034,1530595,common_voice_en_32263840.mp3,Georgia are the defending champions.,6,0,female_feminine,6,4860
6035,1663392,common_voice_en_38018417.mp3,"Ink was actually the second choice, the first being ""Melon"".",6,0,female_feminine,6,5616
6036,564929,common_voice_en_557430.mp3,"It was as if it quivered, but really this was the telescope vibrating.",6,0,female_feminine,6,5976
6037,793910,common_voice_en_37125997.mp3,The other subunit is involved with structure.,6,0,female_feminine,6,5040
6038,289947,common_voice_en_32174766.mp3,He starts to slowly believe what this woman is telling him.,6,0,female_feminine,6,4068
6039,290440,common_voice_en_39585184.mp3,The seat of the municipality is the village Gerani.,6,0,female_feminine,6,4860
6040,1530623,common_voice_en_32263912.mp3,Some of them have threatened to sue the site.,6,0,female_feminine,6,4608
6041,290430,common_voice_en_39585057.mp3,"In the end, they walked away with different views of the film.",6,0,female_feminine,6,5580
6042,564909,common_voice_en_557410.mp3,"My seven year resume gap is marked ""Not Drugs"".",6,0,female_feminine,6,6552
6043,290111,common_voice_en_520581.mp3,"You should see the other guy, specifically, how good at fighting he is.",6,0,female_feminine,6,5856
6044,791692,common_voice_en_598504.mp3,"When the sun sets, the men will once again surrender their arms to me.",6,0,female_feminine,6,8280
6045,564886,common_voice_en_39836602.mp3,"Another football team, The Whitehorse Pioneers, competes in the Eastern Football League.",6,0,female_feminine,6,6876
6046,564885,common_voice_en_39836601.mp3,Its county seat and most populous city is Anthony.,6,0,female_feminine,6,5256
6047,564874,common_voice_en_39836490.mp3,Many of these wooden hairpins were then coated with silver.,6,0,female_feminine,6,4500
6048,564870,common_voice_en_39836470.mp3,That the teams were in two different leagues makes the feat even more unusual.,6,0,female_feminine,6,6048
6049,289948,common_voice_en_32174767.mp3,The antennae are orange with an elongated oval third segment (basoflageomere).,6,0,female_feminine,6,5796
6050,793909,common_voice_en_37125986.mp3,The complexity of the funding formula means that each position depends on one's perspective.,6,0,female_feminine,6,9360
6051,793908,common_voice_en_37125984.mp3,"James Monroe earned the nickname ""The Last Cocked Hat"" because of this.",6,0,female_feminine,6,7164
6052,793905,common_voice_en_37125965.mp3,Many of the manuscripts contain notes and marginalia in the hand of Neilson.,6,0,female_feminine,6,9108
6053,793904,common_voice_en_37125964.mp3,"He exercised a check on extravagance, and helped to abolish the sinking fund.",6,0,female_feminine,6,8496
6054,793867,common_voice_en_37038157.mp3,The journey was uneventful until the vessel reached the Ship Shoal Wreck Buoy.,6,0,female_feminine,6,8280
6055,793898,common_voice_en_37125943.mp3,I don't think that was ever an accurate description of men's lives.,6,0,female_feminine,6,6840
6056,793897,common_voice_en_37125942.mp3,Individually she placed eighth on uneven bars and floor exercise.,6,0,female_feminine,6,6948
6057,793895,common_voice_en_37125929.mp3,Tulelake has a municipal airport.,6,0,female_feminine,6,4464
6058,793891,common_voice_en_37125914.mp3,Others possess a single flagellum that is kept inside the cell wall.,6,0,female_feminine,6,7344
6059,793887,common_voice_en_37038186.mp3,He never saw it as separate from our lives.,6,0,female_feminine,6,4896
6060,793882,common_voice_en_37038180.mp3,The next year his first one-man show was held at the Daniel Gallery.,6,0,female_feminine,6,7344
6061,793861,common_voice_en_37038148.mp3,"Ptolemy's work probably originally came with maps, but none have been discovered.",6,0,female_feminine,6,8532
6062,793877,common_voice_en_37038173.mp3,for example changing colour output at each beat input.,6,0,female_feminine,6,6516
6063,793876,common_voice_en_37038172.mp3,Most of the current school buildings date from around or after this time.,6,0,female_feminine,6,7200
6064,793875,common_voice_en_37038171.mp3,"The lust carries over into the technology, leaving the males' world aghast.",6,0,female_feminine,6,8568
6065,793874,common_voice_en_37038169.mp3,Wortman also killed two dogs and injured two others.,6,0,female_feminine,6,5760
6066,793872,common_voice_en_37038162.mp3,He never again saw his Philippine homeland.,6,0,female_feminine,6,5832
6067,567273,common_voice_en_83133.mp3,Ogilvy watched till one and then gave up.,6,0,female_feminine,6,3504
6068,793871,common_voice_en_37038161.mp3,It also has branched into television shows and event management.,6,0,female_feminine,6,6876
6069,793869,common_voice_en_37038159.mp3,Saint Naum is also buried in the church.,6,0,female_feminine,6,4860
6070,567297,common_voice_en_83157.mp3,The greatest authority on meteorites stated that the height of its first appearance was about ninety or one hundred miles.,6,0,female_feminine,6,7752
6071,793863,common_voice_en_37038151.mp3,It is influenced by authors and thinkers like Jan Narveson and Murray Rothbard.,6,0,female_feminine,6,8856
6072,793862,common_voice_en_37038149.mp3,"During this time, he was also a member of the Philadelphia Woodwind Quintet.",6,0,female_feminine,6,9216
6073,793878,common_voice_en_37038174.mp3,He was born in Kufa in what is now Iraq.,6,0,female_feminine,6,5796
6074,797206,common_voice_en_30453324.mp3,There is nothing to see except the oldest sheds and benches at the platform.,6,0,female_feminine,6,6084
6075,797205,common_voice_en_30453323.mp3,Staff concluded the option offers minimal benefit but high cost.,6,0,female_feminine,6,5436
6076,797204,common_voice_en_30453322.mp3,It flowers from April to June and fruits from August to September.,6,0,female_feminine,6,5436
6077,1530080,common_voice_en_32121196.mp3,Most areas are orchards.,6,0,female_feminine,6,3168
6078,797201,common_voice_en_30453319.mp3,Several cases of sexual violence have been reported since his arrival.,6,0,female_feminine,6,5472
6079,797200,common_voice_en_30453318.mp3,He went to college at Iowa State.,6,0,female_feminine,6,3564
6080,797199,common_voice_en_30453317.mp3,He started the next game against Galway and scored two points.,6,0,female_feminine,6,5220
6081,797197,common_voice_en_30453315.mp3,The Ratta and Shilahara dynasties also worshiped Padmavati as their tutelary deity.,6,0,female_feminine,6,7920
6082,797196,common_voice_en_30453314.mp3,The tensions between Croats and Serbs were high.,6,0,female_feminine,6,5112
6083,797194,common_voice_en_30453312.mp3,The convoy was carrying supplies for the besieged forces on Leyte Island.,6,0,female_feminine,6,6480
6084,797192,common_voice_en_30453310.mp3,Sporting history was made.,6,0,female_feminine,6,5832
6085,1223701,common_voice_en_35261717.mp3,"That following year she collaborated with Black Motion on the ""Mwana Wa Mai"" remix.",6,0,female_feminine,6,9216
6086,1530089,common_voice_en_32121260.mp3,They had three daughters together.,6,0,female_feminine,6,2844
6087,1521923,common_voice_en_36842240.mp3,It was the closest men's single scull final ever.,6,0,female_feminine,6,3528
6088,305019,common_voice_en_56062.mp3,They were relieved and happy.,6,0,female_feminine,6,2280
6089,606421,common_voice_en_37172217.mp3,Its slogan is 'Mighty Mint Chew'.,6,0,female_feminine,6,4500
6090,1521915,common_voice_en_36842222.mp3,Bayburt is traversed by the northeasterly line of equal latitude and longitude.,6,0,female_feminine,6,6408
6091,606427,common_voice_en_37931437.mp3,Wadsworth is home to the Tempel Farms Lipizzan Horses.,6,0,female_feminine,6,5400
6092,1530163,common_voice_en_32122934.mp3,Greetings.,6,0,female_feminine,6,2628
6093,1521893,common_voice_en_36842157.mp3,The English retaliated by attacking and burning down Powhatan villages.,6,0,female_feminine,6,4716
6094,1521892,common_voice_en_36842156.mp3,"The Town of Busti, New York in Chautauqua County is named after him.",6,0,female_feminine,6,4536
6095,1530183,common_voice_en_32123966.mp3,But severe knee injuries forced him to retire early from professional sports.,6,0,female_feminine,6,5472
6096,1521839,common_voice_en_36842084.mp3,Klimenko promotes women in motorsport.,6,0,female_feminine,6,4104
6097,377973,common_voice_en_559703.mp3,It seemed to him that it fell to earth about one hundred miles east of here.,6,0,female_feminine,6,6984
6098,797235,common_voice_en_30453353.mp3,"He belongs to ""the new generation"" of Puerto Rican urban musicians.",6,0,female_feminine,6,6408
6099,797234,common_voice_en_30453352.mp3,One could sleep there and conferences were also hosted.,6,0,female_feminine,6,4896
6100,797233,common_voice_en_30453351.mp3,Normally this was an annual event.,6,0,female_feminine,6,4212
6101,797232,common_voice_en_30453350.mp3,Their sole appearances were in the television specials.,6,0,female_feminine,6,4644
6102,797231,common_voice_en_30453349.mp3,The other prisoners refused to participate and stayed behind.,6,0,female_feminine,6,5688
6103,797229,common_voice_en_30453347.mp3,Nelson has won six awards.,6,0,female_feminine,6,4860
6104,797228,common_voice_en_30453346.mp3,Republican Andrew Shuman was elected Lieutenant Governor of Illinois.,6,0,female_feminine,6,5256
6105,797195,common_voice_en_30453313.mp3,Most of her cargo was saved.,6,0,female_feminine,6,3708
6106,797226,common_voice_en_30453344.mp3,Her research was funded by the National Institute on Minority Health and Health Disparities.,6,0,female_feminine,6,7632
6107,797225,common_voice_en_30453343.mp3,The overall goal is to acquire sufficient victory points to win the game.,6,0,female_feminine,6,7560
6108,797224,common_voice_en_30453342.mp3,The board of directors now includes only Watson and venture capitalist Michael Moe.,6,0,female_feminine,6,8172
6109,797207,common_voice_en_30453325.mp3,Undefeated atomweight Ritu Phogat faced Bi Nguyen.,6,0,female_feminine,6,6840
6110,797222,common_voice_en_30453340.mp3,Cooke died in Singapore.,6,0,female_feminine,6,4752
6111,797220,common_voice_en_30453338.mp3,The Order of Merit was won for the second time by Muriel Thomson.,6,0,female_feminine,6,6984
6112,797219,common_voice_en_30453337.mp3,The Herbert River flows through the middle of the property.,6,0,female_feminine,6,5580
6113,797218,common_voice_en_30453336.mp3,The facade has corinthian pilasters.,6,0,female_feminine,6,6588
6114,797217,common_voice_en_30453335.mp3,The election was won by Jibril Aminu of the Peoples Democratic Party (Nigeria).,6,0,female_feminine,6,7776
6115,797216,common_voice_en_30453334.mp3,Only the platforms and loading bank survive.,6,0,female_feminine,6,4788
6116,797215,common_voice_en_30453333.mp3,The school suspended Few for three games for his actions.,6,0,female_feminine,6,5868
6117,797214,common_voice_en_30453332.mp3,"The ""Brake""s supply of torpedoes were transferred to the ""Egerland"".",6,0,female_feminine,6,5796
6118,797213,common_voice_en_30453331.mp3,The background is that City of Stockholm has developed an official school system.,6,0,female_feminine,6,7848
6119,797212,common_voice_en_30453330.mp3,It occurs in the eastern Pacific Ocean.,6,0,female_feminine,6,4500
6120,797210,common_voice_en_30453328.mp3,The work was supervised by or Franz Exner.,6,0,female_feminine,6,6192
6121,797223,common_voice_en_30453341.mp3,She married to Syed Ahsan Habib who is an electrical engineer.,6,0,female_feminine,6,7524
6122,1223464,common_voice_en_32761944.mp3,He played college football at Kutztown.,6,0,female_feminine,6,4716
6123,301865,common_voice_en_63616.mp3,"Air was either entering or escaping at the rim with a thin, sizzling sound.",6,0,female_feminine,6,5136
6124,301863,common_voice_en_63613.mp3,Replace the Ts in Tim Tebow's name with any other consonant to get a Star Wars character,8,2,female_feminine,6,6816
6125,301861,common_voice_en_63611.mp3,'m all about those invisible cosmic connections that transcend time and distance.,8,2,female_feminine,6,6816
6126,301860,common_voice_en_63610.mp3,"About eleven, I walked back to my home in Maybury because nothing seemed to be happening.",6,0,female_feminine,6,7728
6127,301859,common_voice_en_63608.mp3,Some of the grey ash was falling off the circular edge.,6,0,female_feminine,6,5112
6128,301858,common_voice_en_63607.mp3,He was immensely excited at the news.,6,0,female_feminine,6,4128
6129,1521624,common_voice_en_36746005.mp3,Ever so much fun.,6,0,female_feminine,6,2268
6130,1223531,common_voice_en_32762551.mp3,He was assigned to the budget and treasury as well as economic development committees.,6,0,female_feminine,6,8064
6131,1521577,common_voice_en_36745850.mp3,The airport has a single runway and three gates.,6,0,female_feminine,6,4392
6132,1530315,common_voice_en_32255208.mp3,Mackey won the general election.,6,0,female_feminine,6,3240
6133,1530157,common_voice_en_32122915.mp3,He immigrated to the United States at age five along with his family.,6,0,female_feminine,6,4896
6134,1521506,common_voice_en_36633264.mp3,The Union forces launched another attack on McCausland and Imboden that evening.,6,0,female_feminine,6,4860
6135,1223604,common_voice_en_32838614.mp3,The movie also bagged awards at some film festivals.,6,0,female_feminine,6,5292
6136,1521461,common_voice_en_36633214.mp3,The castle was the caput of the feudal barony of King Edward.,6,0,female_feminine,6,3888
6137,1662398,common_voice_en_38001969.mp3,"At this time, he took his brother's place as lead singer for the band.",6,0,female_feminine,6,6156
6138,1521449,common_voice_en_36633187.mp3,He earned critical acclaim for his performance.,6,0,female_feminine,6,3240
6139,1223646,common_voice_en_32838703.mp3,The deer pasture is dominated by many old oak trees.,6,0,female_feminine,6,5580
6140,1521410,common_voice_en_36613255.mp3,"While this story is very picturesque, it seems unlikely to be true.",6,0,female_feminine,6,4464
6141,569072,common_voice_en_35001911.mp3,"In city planning policy circles, there has been a recent movement toward urban sustainability.",6,0,female_feminine,6,6660
6142,1223676,common_voice_en_34912291.mp3,"When the original building was torn down, the relief was removed.",6,0,female_feminine,6,7272
6143,1660435,common_voice_en_37963253.mp3,The theatres stayed open.,6,0,female_feminine,6,3528
6144,1521352,common_voice_en_36613071.mp3,Dancing on Wheels paired able-bodied celebrities with those in wheelchairs.,6,0,female_feminine,6,4716
6145,1659182,common_voice_en_37942680.mp3,He was cleared of all criminal charges brought against him.,6,0,female_feminine,6,5796
6146,1521823,common_voice_en_36842055.mp3,Eventually when the town was founded it was after the cook's surname.,6,0,female_feminine,6,5148
6147,1521848,common_voice_en_36842100.mp3,"The former Yugoslav Airline, Jugoslovenski Aerotransport, used it for cropspraying.",6,0,female_feminine,6,6984
6148,1521847,common_voice_en_36842099.mp3,"This became the basis for his reputation as the ""World's Strongest Man"".",6,0,female_feminine,6,5580
6149,1660245,common_voice_en_37960977.mp3,These routes are partially signed over locally maintained roads.,6,0,female_feminine,6,6408
6150,1530228,common_voice_en_32149036.mp3,Only two rings are found.,6,0,female_feminine,6,2520
6151,1530202,common_voice_en_32124066.mp3,The club was created in response to one virus and done in by another.,6,0,female_feminine,6,6012
6152,1530244,common_voice_en_32149090.mp3,Jim and the prospector are saved by hiding in the mine.,6,0,female_feminine,6,4536
6153,570362,common_voice_en_132256.mp3,"Down below in the darkness were hundreds of people, sleeping in peace.",6,0,female_feminine,6,6336
6154,1521814,common_voice_en_36811574.mp3,The romance lasted a year.,6,0,female_feminine,6,2736
6155,1521761,common_voice_en_36811474.mp3,Anushirwan's origins are obscure.,6,0,female_feminine,6,3312
6156,570357,common_voice_en_132251.mp3,Some of the grey ash was falling off the circular edge.,6,0,female_feminine,6,4104
6157,1521614,common_voice_en_36745973.mp3,Anya Stanley of Dread Central awarded the film three stars out of five.,6,0,female_feminine,6,6156
6158,1521752,common_voice_en_36811452.mp3,The Holy Sealing the third Holy Sacrament in the Old Apostolic Church.,6,0,female_feminine,6,5184
6159,1521710,common_voice_en_36811400.mp3,It was another great episode by Provenzano and Boyd.,6,0,female_feminine,6,3744
6160,1530274,common_voice_en_32149240.mp3,Few people live permanently in Milford Sound.,6,0,female_feminine,6,3708
6161,1521708,common_voice_en_36811397.mp3,"The river's Big Bend circumscribes Big Bend Golf Course, which also takes its name.",6,0,female_feminine,6,5364
6162,1530276,common_voice_en_32149242.mp3,Three seats available.,6,0,female_feminine,6,2520
6163,1530248,common_voice_en_32149100.mp3,All songs written by Roger Taylor.,6,0,female_feminine,6,3780
6164,1521680,common_voice_en_36746176.mp3,Several other rivers reported river flooding.,6,0,female_feminine,6,2988
6165,1660411,common_voice_en_37962973.mp3,"The annual festival has been based in Brooklyn, New York.",8,2,female_feminine,6,6300
6166,1530326,common_voice_en_32255279.mp3,It was never produced for civilian use.,6,0,female_feminine,6,3600
6167,1223447,common_voice_en_32761811.mp3,"He has stated that some of his points decision losses were ""very controversial"".",6,0,female_feminine,6,7164
6168,1521615,common_voice_en_36745974.mp3,The Islamic Center of Washington was built as a result.,6,0,female_feminine,6,3996
6169,1521765,common_voice_en_36811478.mp3,"Harry is brought to the spaceship of the Zygons, which is deep underwater.",6,0,female_feminine,6,4572
6170,1375538,common_voice_en_38293726.mp3,We are going to swim on Saturday.,6,0,female_feminine,6,4536
6171,914446,common_voice_en_486680.mp3,I was impatient to see it opened.,7,1,female_feminine,6,3528
6172,1375541,common_voice_en_38293758.mp3,In art he was sometimes represented with a shark's body and a human head.,6,0,female_feminine,6,6948
6173,1375542,common_voice_en_38293761.mp3,The method of determining the months and regulating the festivals was a secret.,6,0,female_feminine,6,7920
6174,1375548,common_voice_en_38300234.mp3,"They use their long, straight swords to clear, cut, and dig with.",6,0,female_feminine,6,7776
6175,329681,common_voice_en_57361.mp3,The top of the cylinder was rotating on its body.,6,0,female_feminine,6,5784
6176,329680,common_voice_en_57360.mp3,I got drunk yesterday and thought I built a super computer.,6,0,female_feminine,6,4224
6177,329676,common_voice_en_57356.mp3,Something inside the cylinder was unscrewing the top.,6,0,female_feminine,6,5424
6178,1375555,common_voice_en_38300280.mp3,In the uncertainty of the whole question I leave my theory as it stood.,6,0,female_feminine,6,7236
6179,1375558,common_voice_en_38300294.mp3,From the summit of a pass he gazed with delight down a long valley.,6,0,female_feminine,6,6336
6180,1376170,common_voice_en_38369312.mp3,Joel's Army has been connected to Dominion Theology and Fivefold ministry thinking.,6,0,female_feminine,6,7920
6181,596578,common_voice_en_32641377.mp3,There are narrow teeth on lateral margin of prothorax which are long.,6,0,female_feminine,6,6480
6182,596580,common_voice_en_32641412.mp3,Her father contributed to the release of the latter.,6,0,female_feminine,6,4140
6183,356790,common_voice_en_155430.mp3,"At other times, at a crucial moment, I make it easier for things to happen.",6,0,female_feminine,6,7752
6184,1375581,common_voice_en_38300926.mp3,My father was angry because he had to attend the official gatherings.,6,0,female_feminine,6,6696
6185,596616,common_voice_en_32642077.mp3,He played for Glasgow Academicals and West of Scotland.,6,0,female_feminine,6,5760
6186,1375602,common_voice_en_38325677.mp3,Other fixtures are White House advisers such as Karen Hughes and Karl Rove.,6,0,female_feminine,6,7920
6187,1524267,common_voice_en_23917878.mp3,It is administered by the Palestinian National Internet Naming Authority.,6,0,female_feminine,6,5304
6188,1375604,common_voice_en_38325705.mp3,Their ancestor is recovered from his sickness and has returned.,6,0,female_feminine,6,6048
6189,1375606,common_voice_en_38325708.mp3,"Later he opened a ""Yeshiva Gedola"" as well.",6,0,female_feminine,6,5796
6190,1375639,common_voice_en_38330362.mp3,"In contrast, ideographic compounds are common among characters coined in Japan.",6,0,female_feminine,6,7848
6191,1375614,common_voice_en_38325775.mp3,The earth rests on the shoulders of a mighty giant.,6,0,female_feminine,6,6048
6192,1375563,common_voice_en_38300313.mp3,There seem to be a universal spirit of emulation among them.,6,0,female_feminine,6,6840
6193,1523953,common_voice_en_22527232.mp3,"In Vietnamese culture, the whale shark is referred to as ""sir fish"".",6,0,female_feminine,6,5592
6194,352946,common_voice_en_36394237.mp3,He is best known as the lead vocalist of power metal band Powerwolf.,6,0,female_feminine,6,6192
6195,914438,common_voice_en_486672.mp3,An huge hole had been made by the impact of the projectile.,6,0,female_feminine,6,6120
6196,1524001,common_voice_en_22527286.mp3,"On that date, the organization rebranded as ""U Sports"" in both languages.",6,0,female_feminine,6,5544
6197,1375504,common_voice_en_38293387.mp3,The carrying out of the puppet is accompanied with the singing of a song.,6,0,female_feminine,6,6696
6198,1375505,common_voice_en_38293405.mp3,It was an impossible task for such a primal being.,6,0,female_feminine,6,6840
6199,354250,common_voice_en_140202.mp3,But he knew that Salem wasn't in Andalusia.,6,0,female_feminine,6,4128
6200,354251,common_voice_en_140203.mp3,Henderson went into the railway station to telegraph the news to London.,6,0,female_feminine,6,6144
6201,1375508,common_voice_en_38293416.mp3,It is an anachronism for you to have such thoughts.,6,0,female_feminine,6,6516
6202,1375543,common_voice_en_38293807.mp3,"With the time we have available, it is not possible to list every department.",6,0,female_feminine,6,7596
6203,914413,common_voice_en_486647.mp3,He heard a muffled grating sound and saw the black mark jerk forward an inch or so.,6,0,female_feminine,6,7032
6204,1375537,common_voice_en_38293725.mp3,He heard the sonorous trumpeting of the cranes as they winged their way southward.,6,0,female_feminine,6,8640
6205,1524069,common_voice_en_22528175.mp3,"With wife Louise, he had two children, Sharon and Ronald.",6,0,female_feminine,6,4944
6206,1375514,common_voice_en_38293500.mp3,Many strange customs were observed in this country in former times.,6,0,female_feminine,6,8028
6207,1375518,common_voice_en_38293513.mp3,They are believed to be the spirits of the departed.,6,0,female_feminine,6,7380
6208,1375524,common_voice_en_38293611.mp3,They announce their intention and fix the day of their departure.,6,0,female_feminine,6,8496
6209,354779,common_voice_en_637943.mp3,"One afternoon, one of his servants fell ill, and it appeared that he would die.",6,0,female_feminine,6,4704
6210,1375531,common_voice_en_38293690.mp3,"If there’s nowhere to move, the creature can use the Dodge action.",6,0,female_feminine,6,6948
6211,1523114,common_voice_en_20071145.mp3,In some cases torture was involved.,6,0,female_feminine,6,2976
6212,1375532,common_voice_en_38293694.mp3,The sheaf was bound and dressed in women's clothing.,6,0,female_feminine,6,6768
6213,1375533,common_voice_en_38293696.mp3,Not a lark soared carolling into the blue vault of heaven.,6,0,female_feminine,6,7236
6214,1375534,common_voice_en_38293697.mp3,The exhalations given off by these waters are sometimes fatal.,6,0,female_feminine,6,7920
6215,1375536,common_voice_en_38293724.mp3,It becomes necessary to seclude her from society for a while.,6,0,female_feminine,6,7956
6216,1524058,common_voice_en_22528164.mp3,"The base formerly comprised two separate airfields, Whenuapai and Hobsonville.",6,0,female_feminine,6,6432
6217,1524369,common_voice_en_23918001.mp3,"The record now stands at one win, one draw and ten losses.",6,0,female_feminine,6,4656
6218,1375669,common_voice_en_38334006.mp3,Its municipal seat is located in the city of Tecate.,6,0,female_feminine,6,6336
6219,1522858,common_voice_en_37945545.mp3,To the south is the huge walled plain Hertzsprung.,6,0,female_feminine,6,3672
6220,1375681,common_voice_en_38334622.mp3,Colleges are saving money by replacing full-time professors with adjuncts.,6,0,female_feminine,6,7560
6221,1522843,common_voice_en_37764207.mp3,Pitcairn House is the location of the school's business and development offices.,6,0,female_feminine,6,4428
6222,1375720,common_voice_en_38346635.mp3,"The new carriage also provided a far more stable platform, greatly increasing accuracy.",6,0,female_feminine,6,8460
6223,1375691,common_voice_en_38334727.mp3,He was also the grandfather of folk singer John Craigie.,6,0,female_feminine,6,5940
6224,1375692,common_voice_en_38334749.mp3,"It was named after John J. Gosper, a Secretary of State of Nebraska.",6,0,female_feminine,6,8748
6225,1375694,common_voice_en_38334849.mp3,There are six academic buildings on campus housing classrooms and faculty offices.,6,0,female_feminine,6,7560
6226,1375697,common_voice_en_38335045.mp3,Ireland moved to Jackson Kelly.,6,0,female_feminine,6,5688
6227,1524459,common_voice_en_23918188.mp3,"The film was shot in Riverside Studios, and Felixstowe, Suffolk.",6,0,female_feminine,6,4824
6228,1524298,common_voice_en_23917925.mp3,The hotel is well known for its classic Victorian afternoon tea service.,6,0,female_feminine,6,4416
6229,1524488,common_voice_en_23918229.mp3,These differed only in minor details from the commercial model.,6,0,female_feminine,6,4224
6230,1375716,common_voice_en_38346618.mp3,The octave melody's dotted rhythms and the continuous accompaniment give an impression of tension.,6,0,female_feminine,6,9576
6231,1375721,common_voice_en_38346636.mp3,"They may worship together, exchange clergy, and share commitments to evangelism and service.",6,0,female_feminine,6,9216
6232,1375722,common_voice_en_38346640.mp3,The county town was Middlesbrough.,6,0,female_feminine,6,5976
6233,1522779,common_voice_en_37172218.mp3,The paratroopers surrounded the house and fired a number of shots into the building.,6,0,female_feminine,6,4284
6234,1375732,common_voice_en_38352401.mp3,"John Wesley, rector of Winterborne Whitechurch, Dorset.",6,0,female_feminine,6,7596
6235,1375739,common_voice_en_38352451.mp3,The scheme is specifically aimed at overcoming skills shortages in traditional engineering crafts.,6,0,female_feminine,6,8460
6236,1375744,common_voice_en_38352483.mp3,Gay or bisexual self-identification without same-sex attraction was almost non-existent.,6,0,female_feminine,6,9396
6237,721360,common_voice_en_635039.mp3,Something inside the cylinder was unscrewing the top.,6,0,female_feminine,6,3456
6238,324443,common_voice_en_17815430.mp3,The meek shall inherit the earth.,6,0,female_feminine,6,2736
6239,1375754,common_voice_en_38352525.mp3,Changed pieces of information due to recombination and mutation are randomly chosen.,6,0,female_feminine,6,7128
6240,1375705,common_voice_en_38346527.mp3,This union respected the existing institutions and parliaments of both territories.,6,0,female_feminine,6,9900
6241,1375620,common_voice_en_38325845.mp3,Both remain in use today carrying railway lines across the River Severn.,6,0,female_feminine,6,7236
6242,1375621,common_voice_en_38325847.mp3,"The last sheaf sometimes goes by the name of The Granny"".""",6,0,female_feminine,6,7020
6243,1524306,common_voice_en_23917933.mp3,Due west from the town is the Indian Peaks Wilderness within Roosevelt National Forest.,6,0,female_feminine,6,5496
6244,1522957,common_voice_en_38150634.mp3,"Despite its comedic overtones, ""Defending Your Life"" contains elements of drama and allegory.",6,0,female_feminine,6,5904
6245,596769,common_voice_en_36516718.mp3,Yawls tend to have mainsails almost as large as those of comparable sloops.,6,0,female_feminine,6,6228
6246,1375630,common_voice_en_38325962.mp3,"Tyrants rule not only the land, but also the hearts.",6,0,female_feminine,6,6588
6247,1375631,common_voice_en_38325973.mp3,Without such a renewal he would have forfeited his right to the throne.,6,0,female_feminine,6,8208
6248,1375633,common_voice_en_38326004.mp3,"It is native to southeastern Brazil, Uruguay, and northern Argentina.",6,0,female_feminine,6,7236
6249,1375636,common_voice_en_38326812.mp3,"Caught in a pincer movement, Hamilcar started to march north.",6,0,female_feminine,6,7020
6250,1524328,common_voice_en_23917955.mp3,Zinc is a natural resource.,6,0,female_feminine,6,2856
6251,1375638,common_voice_en_38330361.mp3,The Russian male name Anatoly and the French Anatole share the same linguistic origin.,6,0,female_feminine,6,9828
6252,1522903,common_voice_en_38024627.mp3,The Older Granites date to the late Cambrian and Orduvician.,6,0,female_feminine,6,4644
6253,1375646,common_voice_en_38330387.mp3,Health care providers and public health officers are among the first lines of defense.,6,0,female_feminine,6,7308
6254,596778,common_voice_en_36516727.mp3,"He played with the club during two seasons, as a backup.",6,0,female_feminine,6,4140
6255,1524319,common_voice_en_23917946.mp3,The river is now popular for recreational canoeing and kayaking.,6,0,female_feminine,6,4344
6256,1375653,common_voice_en_38330984.mp3,"MacDonald's step-uncle was a Shakespeare scholar, and his paternal cousin another Celtic academic.",6,0,female_feminine,6,9648
6257,1375687,common_voice_en_38334676.mp3,"Pregnancy is rare, but can occasionally occur naturally as well as through embryo transfer.",6,0,female_feminine,6,8280
6258,1375657,common_voice_en_38331027.mp3,The former First Minister of Scotland Jack McConnell called Bain a Scottish icon.,6,0,female_feminine,6,8856
6259,1375663,common_voice_en_38331064.mp3,He is an ordained bishop of the Universal Church of the Kingdom of God.,6,0,female_feminine,6,7056
6260,1524349,common_voice_en_23917981.mp3,Removal of the metal slat wall cover treatment has begun.,6,0,female_feminine,6,3936
6261,1375665,common_voice_en_38331097.mp3,Gerringong is part of the Municipality of Kiama.,6,0,female_feminine,6,4716
6262,1375666,common_voice_en_38331100.mp3,"Her second album was preceded by the single ""Fault Line (Late July)"".",6,0,female_feminine,6,7668
6263,1524386,common_voice_en_23918033.mp3,Cloud and Rochester.,6,0,female_feminine,6,2064
6264,35,common_voice_en_40269002.mp3,She graduated from the University of New Brunswick.,2,0,non-binary,2,4860
6265,8164,common_voice_en_41074651.mp3,"He was subsequently assigned to minor posts in Jerusalem, Rome, Cambridge and Strasbourg.",6,0,non-binary,6,9612
6266,8165,common_voice_en_41074654.mp3,Farmers responded by resorting to irrigation.,6,0,non-binary,6,5436
6267,9482,common_voice_en_41731588.mp3,He experienced weightlessness and saw the curvature of the Earth.,4,0,non-binary,4,3996
6268,9483,common_voice_en_41735538.mp3,Holmes versus Cooney was refereed by Mills Lane.,4,0,non-binary,4,3564
6269,11984,common_voice_en_41547685.mp3,The mountains separate Luzon's central plain from the South China Sea.,2,0,non-binary,2,5220
6270,11985,common_voice_en_41547689.mp3,Fundamental justice was thus seen as having been violated.,2,0,non-binary,2,4608
6271,51406,common_voice_en_40943937.mp3,Cash flow equals net operating income minus debt service.,3,0,non-binary,3,6264
6272,51407,common_voice_en_40943946.mp3,His season included three games in which he kicked five goals.,3,0,non-binary,3,5220
6273,51408,common_voice_en_40943950.mp3,Eating muesli for breakfast can make me feel to sugary.,3,0,non-binary,3,5184
6274,81192,common_voice_en_40921783.mp3,"The name ""Iran"" means ""Land of the Aryans"".",2,0,non-binary,2,5328
6275,81193,common_voice_en_40921784.mp3,A common theme Women's Studies students engage with is Power and Power Imbalance.,2,0,non-binary,2,7416
6276,81194,common_voice_en_40921785.mp3,In captivity they have been recorded feeding on annelids.,2,0,non-binary,2,5436
6277,221571,common_voice_en_41082533.mp3,"Soon after commissioning, ""Alameda"" was assigned to the Naval Overseas Transportation Service.",2,0,non-binary,2,6480
6278,221572,common_voice_en_41082611.mp3,The play was reportedly controversial.,2,0,non-binary,2,3276
6279,221573,common_voice_en_41082631.mp3,Solo dancers are usually the best dancers in a group or dance school.,2,0,non-binary,2,4860
6280,221574,common_voice_en_41082930.mp3,Jehovah's Witnesses were also sentenced to exile there as being Christian conscientious objectors.,2,0,non-binary,2,6408
6281,221575,common_voice_en_41082939.mp3,"Fire and Song is, in the words of its author, ""a story of Faith"".",2,0,non-binary,2,4752
6282,221576,common_voice_en_41082971.mp3,"Camille was raised in Sweden, Norway and Boston.",6,0,non-binary,6,3744
6283,221577,common_voice_en_41083130.mp3,"In some cases, Kansai dialect uses entirely different words.",2,0,non-binary,2,4860
6284,221578,common_voice_en_41083139.mp3,The windscreen could be removed for aeroscreens to be fitted.,2,0,non-binary,2,4320
6285,221579,common_voice_en_41083148.mp3,The gap is used to avoid the long detour around the cape.,2,0,non-binary,2,4104
